S.No,Candidate,Party,EVM Votes,Postal Votes,Total Votes,Percentage of votes
1,GUMMA THANUJA RANI,Yuvajana Sramika Rythu Congress Party,471470,5535,477005,40.96
2,KOTHAPALLI GEETHA,Bharatiya Janata Party,417113,9312,426425,36.62
3,APPALANARASA PACHIPENTA,Communist Party of India (Marxist),119016,4113,123129,10.57
4,AVASHYA LAHARI . VARAM,Bahujan Samaj Party,24858,892,25750,2.21
5,SAMAREDDY BALAKRISHNA,Independent,9493,42,9535,0.82
6,NIMMAKA JAYARAJU,Independent,8798,664,9462,0.81
7,ATHIDHI,Independent,8121,15,8136,0.7
8,CHANTI BADNAINA,Jai Bharat National Party,7205,47,7252,0.62
9,MOTTADAM . RAJABABU,Bharat Adivasi Party,6370,396,6766,0.58
10,RANJITH KUMAR PALAKA,Independent,6000,47,6047,0.52
11,RAMBABU JALLI,Telugu Rajadhikara Samiti Party,4933,26,4959,0.43
12,MANDALA GIRIDHARA RAO,Independent,4931,36,4967,0.43
13,VUYAKA NIREEKSHAN (V. CHENCHU),India Praja Bandhu Party,4500,42,4542,0.39
14,NOTA,None of the Above,50205,265,50470,4.33
1,PUTTA MAHESH KUMAR,Telugu Desam,737644,8707,746351,54.0
2,KARUMURI SUNIL KUMAR,Yuvajana Sramika Rythu Congress Party,559318,5176,564494,40.84
3,KAVURI LAVANYA,Indian National Congress,19820,1006,20826,1.51
4,AJAY BABU BODA,Navarang Congress Party,12197,13,12210,0.88
5,NITTA AKHILA DHARANI PAL,Bahujan Samaj Party,6664,68,6732,0.49
6,BOKINALA KOTESWARA RAO,Independent,2253,10,2263,0.16
7,RUDRAPAKA RATNA RAO (R.R.R),Andhra Rastra Praja Samithi,1523,3,1526,0.11
8,KANDAVALLI JEEVA DEVA DAYAKAR,Independent,1172,8,1180,0.09
9,AGASTEEN KOMMINA,Independent,1001,3,1004,0.07
10,DR. MENDEM SANTHOSH KUMAR (PEDDA BABULU),Liberation Congress Party,777,9,786,0.06
11,RAJESWARA RAO KONDRU,Bharatheeya Jawan Kisan Party,729,3,732,0.05
12,GODUGUPATI VEERA RAGHAVULU,Pyramid Party of India,710,5,715,0.05
13,BYRABOYINA MALYADRI,Bharatha Chaitanya Yuvajana Party,705,10,715,0.05
14,NOTA,None of the Above,22371,144,22515,1.63
1,BALASHOWRY VALLABHANENI,Janasena Party,712149,12290,724439,55.22
2,SIMHADRI CHANDRA SEKHAR RAO,Yuvajana Sramika Rythu Congress Party,495211,6049,501260,38.21
3,GOLLU KRISHNA,Indian National Congress,31130,695,31825,2.43
4,BAAL SHOURI CHODABATHINA,Jatiya Jana Sena Party,10518,623,11141,0.85
5,DEVAMANI DEVARAPALLI,Bahujan Samaj Party,9911,117,10028,0.76
6,KOMMARAJU SIVA NARASIMHA RAO,All India Forward Bloc,5245,9,5254,0.4
7,VALLABHANENI NAGA PAVAN KUMAR,Independent,5206,14,5220,0.4
8,MARADANI K R SWAMY,Jai Maha Bharath Party,2206,8,2214,0.17
9,GANDHI DHANEKULA,Independent,1989,2,1991,0.15
10,PAMULA BALA SOWRYAMMA,Independent,1576,6,1582,0.12
11,ANUSHA YERUVA,Independent,1233,2,1235,0.09
12,GUDAVALLI VENKATA KEDARESWARA RAO,Independent,1102,9,1111,0.08
13,JOGI VEERANJANEYULU,Independent,1020,2,1022,0.08
14,DAMODARA RAO GUDAVALLI,Independent,928,2,930,0.07
15,APPARAO ENNETI,Independent,625,1,626,0.05
16,NOTA,None of the Above,12008,118,12126,0.92
1,KESINENI SIVANATH (CHINNI),Telugu Desam,784722,9432,794154,58.21
2,KESINENI SRINIVAS (NANI),Yuvajana Sramika Rythu Congress Party,505637,6432,512069,37.53
3,BHARGAV VALLURU,Indian National Congress,23498,608,24106,1.77
4,KRISHNA KISHORE YANAMANDRA,Navataram Party,7710,168,7878,0.58
5,VENKATA ASHOK PAPPURI,Independent,6672,0,6672,0.49
6,DEVARAPALLI MALLIKARJUNA RAO (MAHESH),Independent,3199,0,3199,0.23
7,MEKA VENKATESWARA RAO,Bahujan Samaj Party,2184,49,2233,0.16
8,ANIL KUMAR MADDINENI,Independent,1240,0,1240,0.09
9,BARRE SREENIVASARAO (JAI BHEEM SRINIVAS),Telugu Rajadhikara Samiti Party,609,6,615,0.05
10,SYED KHAMURUNNISA,Navarang Congress Party,600,1,601,0.04
11,CHAGANTIPATI GANGADHAR GANDHI,Pyramid Party of India,486,3,489,0.04
12,DATLA LURTHU MERI,Jaibhim Rao Bharat Party,409,8,417,0.03
13,PERAM SIVA NAGESWARA RAO,Republican Party of India (Athawale),365,3,368,0.03
14,DEVARASETTY RAVEENDRA BABU,Andhra Rastra Praja Samithi,328,3,331,0.02
15,GUJJULA LALITHA,Socialist Unity Centre Of India (COMMUNIST),323,4,327,0.02
16,N DASARADHA RAMI REDDY,All India Jaihind Party,268,1,269,0.02
17,CHINTHALACHERUVU HEMALATHA,Jai Maha Bharath Party,239,5,244,0.02
18,NOTA,None of the Above,9038,155,9193,0.67
1,DR CHANDRA SEKHAR PEMMASANI,Telugu Desam,851020,13928,864948,60.68
2,KILARI VENKATA ROSAIAH,Yuvajana Sramika Rythu Congress Party,513563,6690,520253,36.5
3,JANGALA AJAY KUMAR,Communist Party of India,8317,320,8637,0.61
4,SIVAREDDY. ENDREDDY,Navataram Party,5628,1,5629,0.39
5,TENALI PRAKASH,Bahujan Samaj Party,4172,100,4272,0.3
6,SIKHAKOLLI HEMA GOWRI SHANKAR,Jatiya Jana Sena Party,1959,5,1964,0.14
7,SAMUDRALA CHINNA KOTAIAH,Jaibhim Rao Bharat Party,1748,5,1753,0.12
8,UMAR BHASHA SHAIK,Jana Sahayaka Sakthi,1273,2,1275,0.09
9,SYED. SAIDA,Navarang Congress Party,1216,6,1222,0.09
10,AMBATI CHALAMAIAH,Pyramid Party of India,1029,2,1031,0.07
11,PILLI BABU RAO,Independent,688,4,692,0.05
12,HARI VENKATA SATISH KURNALA,Jai Bharat National Party,540,2,542,0.04
13,VISHNU REDDY LANKIREDDY,Bengaluru Nava Nirmana Party,461,0,461,0.03
14,EMANI. CHANDRASEKHAR RAO,Navodayam Party,409,5,414,0.03
15,SHAIK. KHAJAVALI,Independent,387,4,391,0.03
16,CHALLAPALLI RATAN RAJU,Viduthalai Chiruthaigal Katchi,374,4,378,0.03
17,KANNEBOYINA VAMSI KRISHNA YADAV,Independent,368,7,375,0.03
18,MOHAMMAD KHAJA MOINUDDIN CHISTI PASHA,Andhra Pradesh Rashtra Samithi,353,5,358,0.03
19,GAYATRI AUDHIPUDI,Independent,350,7,357,0.03
20,ASHOK ANAND GALI,Independent,335,0,335,0.02
21,SHAIK ASLAM AKTHER,Independent,334,1,335,0.02
22,PATHAN KHAJA (BASHA),Telugu Rajadhikara Samiti Party,328,4,332,0.02
23,AMARTHALURI VENKATESWARA RAO.,Marxist Communist Party of India (United),308,4,312,0.02
24,DR. RAYAPUDI RAJESH VIJAY KUMAR,Indian Labour Party (Ambedkar Phule),306,4,310,0.02
25,BURAGA RATNAM,Loktantrik Janta Dal,304,12,316,0.02
26,VANKAYALAPATI VENKATA SIVA RAMANJANEYULU,Independent,268,0,268,0.02
27,SIVA PARVATHI,Independent,262,4,266,0.02
28,BOMMASANI MUTYALA RAO,All Peoples Party,200,7,207,0.01
29,SRIKRISHNA AKKISETTI,Independent,179,0,179,0.01
30,MADAVARAPU NAGA RAJU,Independent,172,0,172,0.01
31,NOTA,None of the Above,7210,177,7387,0.52
1,LAVU SRIKRISHNA DEVARAYALU,Telugu Desam,798097,9899,807996,53.88
2,ANIL KUMAR POLUBOINA,Yuvajana Sramika Rythu Congress Party,642186,6081,648267,43.23
3,GARNEPUDI ALEXANDER SUDHAKAR,Indian National Congress,17520,526,18046,1.2
4,ORSU PREMARAJU,Bahujan Samaj Party,5276,33,5309,0.35
5,KUCHIPUDI JOHN BABU,Jaibhim Rao Bharat Party,2328,8,2336,0.16
6,GARLAPATI SUBHASH PREM,Revolutionary Socialist Party,1243,2,1245,0.08
7,YAMPATI VEERANJANEYA REDDY,Independent,1056,1,1057,0.07
8,SUBBARAO CHALLA,Independent,1051,0,1051,0.07
9,ABDUL RAJAK SHAIK,Independent,718,5,723,0.05
10,KOTA POTHURAJU,Pyramid Party of India,667,3,670,0.04
11,P VENKATESH,Jaathia Chethi Vruthula Ikya Vedika Party,385,3,388,0.03
12,PASUPULETI PICHAIAH,National Nava Kranthi Party,353,3,356,0.02
13,PAPPULA SAMBASIVA RAO,Navarang Congress Party,331,1,332,0.02
14,DOCTOR GODA RAMESH KUMAR,Jatiya Jana Sena Party,305,4,309,0.02
15,THOKALA NAGA RAJU,All India Forward Bloc,277,8,285,0.02
16,NOTA,None of the Above,11120,79,11199,0.75
1,KRISHNA PRASAD TENNETI,Telugu Desam,706757,10736,717493,55.16
2,NANDIGAM SURESH BABU,Yuvajana Sramika Rythu Congress Party,503816,5646,509462,39.17
3,J.D. SEELAM,Indian National Congress,41673,1586,43259,3.33
4,DOKKA JAGAN MOHANA RAO,Bahujan Samaj Party,6774,83,6857,0.53
5,NALAMALA TIRUPATI RAO,Navataram Party,2888,76,2964,0.23
6,BUSSA. NAGARAJU,Independent,1311,7,1318,0.1
7,GADDE. VIJAYA LAKSHMI,Independent,1046,5,1051,0.08
8,KATTAPOGU. VIJAY KUMAR,Pyramid Party of India,893,4,897,0.07
9,KONDRU KIRAN KUMAR,Independent,791,6,797,0.06
10,KATTA ANAND BABU,Independent,704,25,729,0.06
11,MERUGUPALA SADASIVA RAO,India Praja Bandhu Party,669,4,673,0.05
12,KATTA HEMANAND,Independent,547,2,549,0.04
13,PARRE. KOTAIAH,Jaibhim Rao Bharat Party,408,4,412,0.03
14,PALADUG VIJENDRA RAO (BAHUJAN),Liberation Congress Party,294,12,306,0.02
15,CHINNAM MURALIDHAR,All Peoples Party,252,3,255,0.02
16,NOTA,None of the Above,13599,124,13723,1.06
1,MAGUNTA SREENIVASULU REDDY,Telugu Desam,689829,12065,701894,49.35
2,DR CHEVIREDDY BHASKAR REDD,Yuvajana Sramika Rythu Congress Party,644052,7643,651695,45.82
3,EDA SUDHAKARA REDDY,Indian National Congress,25803,919,26722,1.88
4,DHARANIKOTA LAKSHMI NARAYANA,Bahujan Samaj Party,6238,76,6314,0.44
5,BUCHI EDUKONDALU,Independent,3046,2,3048,0.21
6,PODILI RAMBABU,Independent,3035,38,3073,0.22
7,ORSU VEENA,Jai Bharat National Party,2242,25,2267,0.16
8,BONTHA RANGA REDDY,Independent,1923,0,1923,0.14
9,BODDU KRANTHI KUMAR,Independent,1797,1,1798,0.13
10,MOHAN GOUD J V,Independent,1442,5,1447,0.1
11,U MADHU BABU,Independent,1006,2,1008,0.07
12,KARATAPU RAJU,Independent,730,5,735,0.05
13,JAGADEESH RAYAPATI,Independent,713,12,725,0.05
14,DEVIREDDY BALANJANEYULU,Independent,710,6,716,0.05
15,HARI PRASAD TUPAKULA,Independent,706,5,711,0.05
16,PASAM VENKATESWARLU YADAV,Samajwadi Party,699,44,743,0.05
17,SURYA TEJA KOTA,Pyramid Party of India,674,9,683,0.05
18,AKUMALLA MALLIKARJUNA REDDY,Independent,575,0,575,0.04
19,VESHAPOGU GURAVABABU,Independent,457,4,461,0.03
20,KOMMU YOHANU,Liberation Congress Party,454,7,461,0.03
21,SESHUBABU GUDDANTI,Independent,449,0,449,0.03
22,SINGAMNENI SREEKANTH,Independent,407,3,410,0.03
23,YARRA DASARADHARAMAIAH,Independent,394,0,394,0.03
24,KOTA VAMSI KRISHNA,Independent,365,0,365,0.03
25,K PAVAN KALYAN,Jatiya Jana Sena Party,362,30,392,0.03
26,NOTA,None of the Above,13066,139,13205,0.93
1,DR BYREDDY SHABARI,Telugu Desam,689417,11714,701131,49.92
2,POCHA BRAHMANANDA REDDY,Yuvajana Sramika Rythu Congress Party,583155,6001,589156,41.95
3,J LAKSHMI NARASIMHA YADAV,Indian National Congress,54920,1284,56204,4.0
4,P GURUVAIAH,Independent,8190,1,8191,0.58
5,A CHINNA MOULALI,Bahujan Samaj Party,7768,63,7831,0.56
6,HAFIZ ATAULLAH KHAN,Social Democratic Party Of India,6858,74,6932,0.49
7,KOMMUSANI PEDDA KAMBAGIRI SWAMY,Independent,4633,0,4633,0.33
8,GAGGERA VENKATA RAMANAIAH,Independent,3027,4,3031,0.22
9,DUMAVATH SWAMY NAIK,Independent,2348,10,2358,0.17
10,KUNUKUNTLA RAMUDU,Independent,1408,5,1413,0.1
11,E ANIL KUMAR,Independent,1332,2,1334,0.09
12,C SURENDRA NATHA REDDY,Independent,1267,1,1268,0.09
13,BRAHMANANDA REDDY K,Independent,1261,11,1272,0.09
14,UPPU SUBBARAYUDU,Jaathia Chethi Vruthula Ikya Vedika Party,785,6,791,0.06
15,NAGESWARA RAO,Independent,678,2,680,0.05
16,VIJAYA BHASKAR REDDYPOGU,Independent,641,0,641,0.05
17,YELAMPALLE GOVARDHAN REDDY,All India Forward Bloc,638,4,642,0.05
18,BHUMA VEERA BHADRA REDDY,Navarang Congress Party,630,16,646,0.05
19,PANDU RANGA YADAV SIDDAPU,Samajwadi Party,594,11,605,0.04
20,CHANDINI REDDY VAKATI,Liberation Congress Party,546,10,556,0.04
21,B C RAMANADHA AREDDY,Independent,472,0,472,0.03
22,GAJULA SHALIMIYA,Anna YSR Congress Party,468,18,486,0.03
23,KULURU RAMA KRISHNA REDDY,Neethi Nijayithi Party,428,2,430,0.03
24,CH P MALLESWARUDU,Independent,417,4,421,0.03
25,I V PAKKIR REDDY,Independent,408,2,410,0.03
26,V MADHUSUDHANA REDDY,Independent,399,2,401,0.03
27,BUSHAKU MAHESWARA REDDY,Independent,390,0,390,0.03
28,U P MUNI REDDY,Independent,376,0,376,0.03
29,GOGULA SUGUNAMMA,Jai Maha Bharath Party,375,4,379,0.03
30,BELLAMKONDA SREENIVASULU,Independent,352,1,353,0.03
31,BALIJA SHIVA KUMAR,Independent,288,0,288,0.02
32,NOTA,None of the Above,10538,159,10697,0.76
1,BASTIPATI NAGARAJU PANCHALINGALA,Telugu Desam,650335,8579,658914,49.51
2,B Y RAMAIAH,Yuvajana Sramika Rythu Congress Party,543801,3815,547616,41.15
3,P.G.RAMPULLAIAH YADAV LUCKY-2,Indian National Congress,68972,1401,70373,5.29
4,MANCHALA LAKSHMI NARAYANA,Bahujan Samaj Party,8533,56,8589,0.65
5,BOYA SURESH,Independent,5891,9,5900,0.44
6,T. BEECHUPALLI,Independent,5125,2,5127,0.39
7,VIJAYA BHASKAR .REDDYPOGU,Independent,3504,4,3508,0.26
8,PAGADALA KODANDA,Independent,3070,6,3076,0.23
9,DEVARAPOGU MADDILETY,Independent,2576,6,2582,0.19
10,PRAKASH REDDY RALAMPADU,Independent,2222,3,2225,0.17
11,JAHANGIR AHMED,Social Democratic Party Of India,2058,16,2074,0.16
12,DR. REDDYPOGU PRAVEEN KUMAR,Independent,1847,9,1856,0.14
13,ABDUL SATTAR A.S.R,Anna YSR Congress Party,1565,36,1601,0.12
14,VALMIKI ARJUNA,Bharatha Chaitanya Yuvajana Party,1385,5,1390,0.1
15,URUKUNDU VADDE,Independent,1284,11,1295,0.1
16,MALLEPOGU NAGANNA,Socialist Unity Centre Of India (COMMUNIST),1162,2,1164,0.09
17,SUNKARA SREEDHAR,Jai Bharat National Party,1149,14,1163,0.09
18,TARIGOPULA RAJABABU,All Peoples Party,1032,1,1033,0.08
19,AMRUTH KUMAR SALKAPURAM,Liberation Congress Party,777,6,783,0.06
20,NOTA,None of the Above,10394,117,10511,0.79
1,AMBICA G LAKSHMINARAYANA VALMIKI,Telugu Desam,755862,12383,768245,53.33
2,MALAGUNDLA SANKAR NARAYANA,Yuvajana Sramika Rythu Congress Party,573769,5921,579690,40.24
3,MALLIKARJUNA VAJJALA,Indian National Congress,41954,1263,43217,3.0
4,G.V.RAMANA REDDY,Independent,6436,3,6439,0.45
5,BANASI NARAYANAPPA,Bahujan Samaj Party,6280,116,6396,0.44
6,V.MURALI PRASAD REDDY,Independent,5775,3,5778,0.4
7,DR.NALLANI RAMESH NAIDU,Andhra Rastra Praja Samithi,4862,127,4989,0.35
8,M.SURENDRA,Pyramid Party of India,2927,8,2935,0.2
9,U.C.VENKATASUBBAIAH,Jaathia Chethi Vruthula Ikya Vedika Party,2533,7,2540,0.18
10,P.CHOWDESWARI,Independent,1514,4,1518,0.11
11,VADLA KESAVAIAH,Independent,1488,6,1494,0.1
12,B.RAGHAVENDRA PRASAD,Independent,1317,1,1318,0.09
13,KETHIREDDY RAGHUNATHAREDDY,Independent,1086,5,1091,0.08
14,LOKANATH GOWD SURAGOWINI,Independent,1085,6,1091,0.08
15,SREERANGARAJULA GOPINATH ROYAL,Independent,903,1,904,0.06
16,SHAIK.NIZAM,Samajwadi Party,749,4,753,0.05
17,RAMAVTH CHINNA RAMAPPA NAIK,Jaibhim Rao Bharat Party,735,10,745,0.05
18,KURUBA MALLIKARJUNA.S.,All India Kisan Janatha party,574,4,578,0.04
19,B.NAGAMUTHYALU,Socialist Unity Centre Of India (COMMUNIST),566,4,570,0.04
20,SRINIVASA RAJU.O,Bhartiya Panchyat Party,489,5,494,0.03
21,DURGA PRASAD D BYATARAYANAJI,Challengers Party,439,5,444,0.03
22,NOTA,None of the Above,9014,185,9199,0.64
1,KINJARAPU RAMMOHAN NAIDU,Telugu Desam,734501,19827,754328,61.05
2,TILAK PERADA,Yuvajana Sramika Rythu Congress Party,420394,6033,426427,34.51
3,PEDADA PARAMESWARA RAO,Indian National Congress,6724,448,7172,0.58
4,SANAPALA SRAVAN KUMAR,Independent,5950,8,5958,0.48
5,NAIDUGARI RAJASEKHAR,Bahujan Samaj Party,4661,81,4742,0.38
6,VABA YOGESWARA RAO,Independent,3472,126,3598,0.29
7,BETHA VIVEKANANDA MAHARAJ,Independent,2523,13,2536,0.21
8,YEDDU LAKSHMINARAYANA,Independent,1598,7,1605,0.13
9,BORUBADRA CHANDRAKALA,Bharatha Chaitanya Yuvajana Party,1315,42,1357,0.11
10,IPPILI SEETHARAJU,Jai Bharat National Party,1080,50,1130,0.09
11,KAYA DURGARAO,Navarang Congress Party,811,7,818,0.07
12,CHELLURI DANIYAL,Independent,796,20,816,0.07
13,BOMMALI TIRUPATI RAO,Pyramid Party of India,589,5,594,0.05
14,NOTA,None of the Above,24498,107,24605,1.99
1,B K PARTHASARATHI,Telugu Desam,713013,12521,725534,51.23
2,J SHANTHA,Yuvajana Sramika Rythu Congress Party,587406,5701,593107,41.88
3,B A SAMAD SHAHEEN,Indian National Congress,53989,1070,55059,3.89
4,BHAGYA R S,Bahujan Samaj Party,7949,66,8015,0.57
5,PRATHAP REDDY GORLA,Independent,5380,64,5444,0.38
6,H D HANUMANTHE GOWD,Independent,2270,8,2278,0.16
7,ANJINAPPA GARI SREENIVASULU,Revolutionary Socialist Party,2045,6,2051,0.14
8,S N SURESH,Independent,1611,20,1631,0.12
9,DASAGANIPALLI KULLAYAPPA,Independent,1317,11,1328,0.09
10,ASHOK,Socialist Unity Centre Of India (COMMUNIST),1282,10,1292,0.09
11,T SUDHAKAR REDDY,Independent,1227,10,1237,0.09
12,S RAGHUNATHA REDDY,Independent,693,17,710,0.05
13,BUDILI DHANUNJAYA,National Nava Kranthi Party,679,3,682,0.05
14,NOTA,None of the Above,17826,145,17971,1.27
1,Y. S. AVINASH REDDY,Yuvajana Sramika Rythu Congress Party,598406,6737,605143,45.78
2,CHADIPIRALLA BHUPESH SUBBARAMI REDDY,Telugu Desam,532358,10090,542448,41.03
3,Y.S. SHARMILA REDDY,Indian National Congress,136395,4644,141039,10.67
4,PANDITI. GURAPPA.,Bahujan Samaj Party,3790,20,3810,0.29
5,VENU GOPAL RACHINENI,Rashtriya Praja Congress (Secular),3500,70,3570,0.27
6,CHINNAPUREDDY GOPALA KRISHNA REDDY,Independent,2414,16,2430,0.18
7,KUNCHAM. VENKATA SUBBA REDDY,Rayalaseema Rashtra Samithi,2329,4,2333,0.18
8,L. KHAJA HUSSAIN,Independent,1087,1,1088,0.08
9,ANKIREDDY. SURESH KUMAR REDDY.,All India Forward Bloc,752,3,755,0.06
10,KAKARLA SHANMUKHA REDDY,Independent,633,14,647,0.05
11,PALLE RAMESH,Jaibhim Rao Bharat Party,619,5,624,0.05
12,CHAN BASHA. S,Anna YSR Congress Party,432,7,439,0.03
13,J. V. RAMANA,Jaathia Chethi Vruthula Ikya Vedika Party,414,20,434,0.03
14,MALIKIREDDY. HANUMANTHA REDDY,Jana Sahayaka Sakthi,358,11,369,0.03
15,NOTA,None of the Above,16660,186,16846,1.27
1,PRABHAKAR REDDY VEMIREDDY,Telugu Desam,750771,15431,766202,55.7
2,VENUMBAKA VIJAYASAI REDDY,Yuvajana Sramika Rythu Congress Party,514375,5925,520300,37.82
3,KOPPULA RAJU,Indian National Congress,53264,1580,54844,3.99
4,BHASKAR NASINA,Bahujan Samaj Party,5710,101,5811,0.42
5,VIVEKA MANNEPALLI,Revolutionary Socialist Party,2794,10,2804,0.2
6,KOPPALA RAGHU,Independent,2010,5,2015,0.15
7,GAJULA SOMA SEKHAR,Jai Bharat National Party,1775,4,1779,0.13
8,SHAIK MUZIBUR RAHAMAN,Pyramid Party of India,1315,15,1330,0.1
9,SHAIK MAHABOOB BASHA (MABU),Republican Party of India (A),1228,5,1233,0.09
10,MALLEPALLY RAGHU,Navarang Congress Party,1104,1,1105,0.08
11,SHAIK SHAFI AHMED,All India Forward Bloc,1037,0,1037,0.08
12,NAKKA DINESH,Bharatha Chaitanya Yuvajana Party,576,24,600,0.04
13,TALARI VENKATAIAH,Jaibhim Rao Bharat Party,553,5,558,0.04
14,PUNGANURU PRASANNA GANAPATHI,Radical Party of India (Ambedkarist),452,2,454,0.03
15,NOTA,None of the Above,15454,123,15577,1.13
1,GURUMOORTHY MADDILA,Yuvajana Sramika Rythu Congress Party,626702,5526,632228,45.73
2,VARA PRASAD RAO VELAGAPALLI,Bharatiya Janata Party,608494,9165,617659,44.67
3,CHINTA MOHAN,Indian National Congress,63790,1733,65523,4.74
4,PENUMURU. GURAPPA,Bahujan Samaj Party,10300,206,10506,0.76
5,KATTAMANCHI. PRABHAKAR,Independent,5796,6,5802,0.42
6,M UMADEVI,Janata Congress,5387,38,5425,0.39
7,ALLAM.RAJA,Independent,4948,22,4970,0.36
8,VIJAY KUMAR G.SRKR,Liberation Congress Party,4108,194,4302,0.31
9,ANJAIAH.P,Republican Party of India (A),3657,9,3666,0.27
10,V.C. NAVEEN GUPTA,Independent,1723,8,1731,0.13
11,A. VARAPRASAD,Jatiya Jana Sena Party,1668,30,1698,0.12
12,SYAMDHAN KURAPATI,Aihra National Party,1567,1,1568,0.11
13,C. PUNYAMURTHY,United Republican Party of India,1511,4,1515,0.11
14,KARRA SIVA,Pyramid Party of India,1501,9,1510,0.11
15,VELURU. THEJOVATHI,Samajwadi Party,1362,27,1389,0.1
16,C. DAVID,Indian Believers Party (IBP),1237,2,1239,0.09
17,K. JEEVARATHNAM,Independent,1203,1,1204,0.09
18,DASARI. GOWTHAM,Independent,1077,10,1087,0.08
19,VIJAYA KUMAR.G,Independent,797,4,801,0.06
20,A. MADHU,Jai Hindustan Party,711,0,711,0.05
21,B. BHARANI BAS,Ambedkar National Congress,688,0,688,0.05
22,Y. MAHESH,Independent,615,7,622,0.04
23,PRASAD PATIBANDLA,Independent,607,1,608,0.04
24,NOTA,None of the Above,15909,209,16118,1.17
1,P V MIDHUN REDDY,Yuvajana Sramika Rythu Congress Party,639111,5733,644844,48.38
2,NALLARI KIRAN KUMAR REDDY,Bharatiya Janata Party,557030,11743,568773,42.67
3,SHAIK BASHEED,Indian National Congress,52229,1071,53300,4.0
4,ABBAVARAM UGENDRA,Bahujan Samaj Party,12306,57,12363,0.93
5,POOLA REDDY SEKHAR,Independent,6097,3,6100,0.46
6,NAGARAJU JETTI,Independent,5984,15,5999,0.45
7,PRADEEP PENAMADU,All India Forward Bloc,5671,1,5672,0.43
8,CHOUDVARAM SUBBANARASAIAH,Independent,4731,4,4735,0.36
9,PULI SREENIVASULU,Independent,4613,3,4616,0.35
10,SREENIVASULU MARRIPATI,Independent,4436,7,4443,0.33
11,AKBAR M BASHA,Anna YSR Congress Party,2394,17,2411,0.18
12,SANGARAJU NAGESWARA RAJU,Independent,1523,12,1535,0.12
13,MADA RAJA,Jaathia Chethi Vruthula Ikya Vedika Party,1415,0,1415,0.11
14,BATTHALA RAMANAIAH,Jai Bharat National Party,1360,6,1366,0.1
15,DODDAPANENI RAJA NAIDU,Independent,1315,3,1318,0.1
16,MAYANA MOHAMMED SALMAN KHAN,Liberation Congress Party,1069,2,1071,0.08
17,KASTURI OBAIAH NAIDU,Independent,885,2,887,0.07
18,ASADI VENKATADRI,Independent,689,2,691,0.05
19,NOTA,None of the Above,11324,76,11400,0.86
1,DAGGUMALLA PRASADA RAO,Telugu Desam,765536,12535,778071,54.84
2,REDDEPPA.N .,Yuvajana Sramika Rythu Congress Party,552469,5123,557592,39.3
3,MOTUKUR JAGAPATHI,Indian National Congress,29431,719,30150,2.12
4,THOGURU VIJAYA KUMAR,Bahujan Samaj Party,13389,122,13511,0.95
5,YUGANDAR . KONDA,Independent,6889,84,6973,0.49
6,K.MUNI KRISHNA,Independent,3954,2,3956,0.28
7,P.JANAKI RAMA RAO ( BABU),National Maha Sabha Party,2822,11,2833,0.2
8,PETA.MOHAN .,Independent,2365,1,2366,0.17
9,C.SUDHAKAR,Independent,1934,1,1935,0.14
10,N.CHANDRABABU,Independent,1878,7,1885,0.13
11,MADASI SUDHARSHAN,Independent,1575,3,1578,0.11
12,D.MAHESH,Independent,1109,10,1119,0.08
13,P.MADHU,Independent,902,4,906,0.06
14,N.BHUPATHI,Independent,862,32,894,0.06
15,A. PURNA CHANDRA,Independent,856,1,857,0.06
16,PALLIPATTU.ABHINAV VISHNU,Samajwadi Party,670,6,676,0.05
17,N.GANGAIAH .,Independent,547,5,552,0.04
18,T NARESH,Independent,532,2,534,0.04
19,BANDAPALLI RAMESH,Independent,490,3,493,0.03
20,NOTA,None of the Above,11812,164,11976,0.84
1,APPALANAIDU KALISETTI,Telugu Desam,729284,13829,743113,57.2
2,BELLANA CHANDRASEKHAR,Yuvajana Sramika Rythu Congress Party,487691,6071,493762,38.0
3,BOBBILI SRINU,Indian National Congress,10270,353,10623,0.82
4,PEERUBANDI PRAKASH RAO,Bahujan Samaj Party,7985,53,8038,0.62
5,VELURI VENKATA TRINADHARAO,Independent,4146,6,4152,0.32
6,ALLU SRIRAMULU,Independent,3396,5,3401,0.26
7,SIYYADULA YELLA RAO,Independent,3105,2,3107,0.24
8,SRINIVASA RAO SAMBHANA,Yuga Thulasi Party,1758,3,1761,0.14
9,MARISERLA KRISHNAMURTHY NAIDU,Independent,1617,12,1629,0.13
10,VANGAPANDU MAHESWARA RAO,Naba Bharata Nirmana Seva Party,1544,9,1553,0.12
11,CHINNAM ARUNA KUMAR,Jaibhim Rao Bharat Party,1401,10,1411,0.11
12,ATCHIYYA NAIDU SAMIREDDY,Samajwadi Party,1059,11,1070,0.08
13,ADINARAYANA TADDI,Independent,855,1,856,0.07
14,P V A ANANDA SAGAR,Independent,787,4,791,0.06
15,SAKHINETI ANANTHA RAJU,Pyramid Party of India,715,10,725,0.06
16,NOTA,None of the Above,23097,153,23250,1.79
1,SRIBHARAT MATHUKUMILI,Telugu Desam,893884,13583,907467,65.42
2,JHANSI LAKSHMI. BOTCHA.,Yuvajana Sramika Rythu Congress Party,397821,5399,403220,29.07
3,P. SATYA REDDY,Indian National Congress,29430,837,30267,2.18
4,K.A. PAUL,Praja Shanthi Party,7529,167,7696,0.55
5,PEDAPENKI SIVA PRASADA RAO,Bahujan Samaj Party,6006,85,6091,0.44
6,BIKKAVOLU. CHALAMAJI,Navarang Congress Party,4883,1,4884,0.35
7,V.N. SATYA NARAYANA,Rashtriya Praja Congress (Secular),2534,3,2537,0.18
8,ARUNA SRI MURALA,Independent,1991,2,1993,0.14
9,VASUPILLI SURESH,Independent,1931,2,1933,0.14
10,SONDI KRISHNA.,Independent,1811,7,1818,0.13
11,ANDUKURI VIJAYA BHASKAR,India Praja Bandhu Party,1098,11,1109,0.08
12,DR. GANAPATHI KONGARAPU.,Republican Party of India (A),944,6,950,0.07
13,BANNA. RAMESH,Dalita Bahujana Party,941,7,948,0.07
14,P. SATYA VANI,Pyramid Party of India,875,7,882,0.06
15,DURGA PRASAD. GUNTU,Bhartiya Rashtriya Dal,760,7,767,0.06
16,CHAPPIDI RAMU,Independent,756,1,757,0.05
17,M.G.M. KHAN,Independent,738,4,742,0.05
18,SHANKAR DEVARA YADAV,Independent,656,5,661,0.05
19,VENU MADHAV KARRI,Independent,646,1,647,0.05
20,DR. ACHUTHA BALAJI YADAV (MURAPALA),Bharatha Chaitanya Yuvajana Party,628,10,638,0.05
21,THOTA VENKATA SAI MUKUND,Praja Prasthanam Party,628,5,633,0.05
22,PIDIDHI APPARAO,Independent,576,4,580,0.04
23,G.A.N. ANAND,Independent,543,0,543,0.04
24,VADDI. HARI GANESH,Independent,518,2,520,0.04
25,JANARDHAN PONNADA.,Independent,499,1,500,0.04
26,GANAPATHI. JAGADEESWARA RAO (JAGADEESH),Jai Maha Bharath Party,494,6,500,0.04
27,JALADI VIJAYA KUMARI,Samajwadi Party,463,3,466,0.03
28,CHINTADA SURYAM,Naba Bharata Nirmana Seva Party,443,5,448,0.03
29,GANDIKOTA RAJESH,Navataram Party,392,1,393,0.03
30,KOLLI NAGA RAJU,Independent,322,7,329,0.02
31,METTA RAMA RAO,Independent,320,6,326,0.02
32,LAGUDU. GOVINDA RAO,Independent,293,1,294,0.02
33,MALLA SRAVANI,Independent,271,2,273,0.02
34,NOTA,None of the Above,5171,142,5313,0.38
1,C.M.RAMESH,Bharatiya Janata Party,750027,12042,762069,57.5
2,BUDI MUTYALA NAIDU,Yuvajana Sramika Rythu Congress Party,459762,5777,465539,35.13
3,VEGI VENKATESH,Indian National Congress,24833,818,25651,1.94
4,PALAKA SREERAMA MURTHY,Bahujan Samaj Party,19082,75,19157,1.45
5,VANKAYALA RAMACHANDRA RAO,Independent,4001,1,4002,0.3
6,LOVARAJU SIDDHA,Independent,3845,7,3852,0.29
7,KRISHNA SWAROOP VADLAMURI,Dalita Bahujana Party,3549,8,3557,0.27
8,GARA SURYA RAO,Independent,3116,8,3124,0.24
9,APPALA RAJU NAMMI,Bharatha Chaitanya Yuvajana Party,2589,30,2619,0.2
10,NAGESWARA RAO PETLA,Independent,2179,5,2184,0.16
11,ADARI SARAT CHANDRA,Jai Bharat National Party,1886,27,1913,0.14
12,VIJAYA LAKSHMI KARRI,Pyramid Party of India,1578,13,1591,0.12
13,DR. THUMMAPALA HARI SHANKAR,Independent,1567,9,1576,0.12
14,JUNNURI J SRINIVAS,Independent,1195,6,1201,0.09
15,APPALANAIDU TUMMAGUNTA,Independent,1055,7,1062,0.08
16,NOTA,None of the Above,26084,151,26235,1.98
1,TANGELLA UDAY SRINIVAS (TEA TIME UDAY),Janasena Party,718971,10728,729699,54.87
2,CHALAMALASETTY SUNIL,Yuvajana Sramika Rythu Congress Party,495188,5020,500208,37.62
3,MALLIPUDI MANGAPATI PALLAM RAJU,Indian National Congress,20258,851,21109,1.59
4,UDAY,Navarang Congress Party,15578,125,15703,1.18
5,KANDREGULA NARASIMHAM,Bahujan Samaj Party,11916,63,11979,0.9
6,DR ANUSHA YADAV,Bharatha Chaitanya Yuvajana Party,9818,36,9854,0.74
7,TANGELLA SRINIVASU,Jatiya Jana Sena Party,6516,43,6559,0.49
8,YEDIDA VARA PRASAD KUMAR,Republican Party of India (A),3924,3,3927,0.3
9,BUGATHA BANGARRAO,Communist Party of India (Marxist-Leninist) (Liberation),2816,7,2823,0.21
10,SUDHA VEERA GANESH,Independent,2645,2,2647,0.2
11,BHAVANI SANKAR PRASAD MERLA,Independent,1963,6,1969,0.15
12,YENUGUPALLI KRISHNA,Jaibhim Rao Bharat Party,1762,18,1780,0.13
13,BODDETI APPARAO,Independent,1687,0,1687,0.13
14,NEELAKANTAM DONAM,Independent,1401,11,1412,0.11
15,PASUPULETI S.V.S.BHUSHANAM,Independent,1222,5,1227,0.09
16,NOTA,None of the Above,17105,115,17220,1.29
1,G M HARISH (BALAYOGI),Telugu Desam,786149,10832,796981,61.25
2,RAPAKA VARAPRASADA RAO,Yuvajana Sramika Rythu Congress Party,450362,4423,454785,34.95
3,GOUTHAM JANGA,Indian National Congress,14523,559,15082,1.16
4,DORABABU YALLA,Bahujan Samaj Party,5202,186,5388,0.41
5,KATRU NAGA BABU,Telugu Nava Garjana Party,3736,5,3741,0.29
6,VADDI LALITH KUMAR,Independent,2974,3,2977,0.23
7,MAKEY DAVY PRASAD,Independent,2104,7,2111,0.16
8,GUDE VENKATESWARULU,Independent,1741,4,1745,0.13
9,RAMESH JILLELLA,Jatiya Jana Sena Party,866,6,872,0.07
10,YALANGI RAMESH,Jaibhim Rao Bharat Party,738,2,740,0.06
11,MATHA KRISHNA,Pyramid Party of India,718,1,719,0.06
12,GIDDI JNANA PRAKASA RAO,Republican Party of India,717,9,726,0.06
13,YADLA RAJESH,Liberation Congress Party,628,7,635,0.05
14,KAPA KALYAN,Republican Party of India (A),579,2,581,0.04
15,PATHURI RAMESH,Peoples Party of India (Democratic),502,3,505,0.04
16,NOTA,None of the Above,13418,100,13518,1.04
1,DAGGUBATI PURANDHESHWARI,Bharatiya Janata Party,718641,7874,726515,54.82
2,DR. GUDURI SRINIVAS,Yuvajana Sramika Rythu Congress Party,483172,4204,487376,36.77
3,GIDUGU RUDRARAJU,Indian National Congress,31441,1067,32508,2.45
4,GANESWARA RAO PARAMATA,Bahujan Samaj Party,20277,132,20409,1.54
5,BATTULA BALARAMAKRISHNA,Navarang Congress Party,16930,78,17008,1.28
6,SALOPANTULA RAGHAVENDRA RAO,Independent,3261,17,3278,0.25
7,DR. MEDISI RATNARAO ALIAS VINAY,Independent,3109,6,3115,0.24
8,MOHANARAO SINGULURI,Jai Bharat National Party,2818,15,2833,0.21
9,MEDA SRINIVASA RAO,Rashtriya Praja Congress (Secular),2422,7,2429,0.18
10,BOMMANABOINA VSR MURTHY,Independent,2173,6,2179,0.16
11,BHANU CHANDAR KURUVELLA,Independent,1955,3,1958,0.15
12,JALLI BALA NAVEENA,Independent,1250,4,1254,0.09
13,NOTA,None of the Above,24302,133,24435,1.84
1,BHUPATHI RAJU SRINIVASA VARMA (B.J.P.VARMA),Bharatiya Janata Party,699382,7961,707343,57.46
2,UMABALA GUDURI,Yuvajana Sramika Rythu Congress Party,426037,4504,430541,34.98
3,K.B.R.NAIDU,Indian National Congress,34298,915,35213,2.86
4,PRASANNA KUMAR UNDURTHI,Independent,6350,14,6364,0.52
5,MEDAPATI VENKATA VARAHALA REDDY,Independent,5966,3,5969,0.48
6,SIRRA RAJU,Bahujan Samaj Party,5945,69,6014,0.49
7,BALAGAM NAYAKAR,Independent,5232,8,5240,0.43
8,NALLI RAJESH,Independent,4684,0,4684,0.38
9,KETHA SREENU,Independent,3140,5,3145,0.26
10,OLETY NAGENDRA KRISHNA,Jaibhim Rao Bharat Party,3112,4,3116,0.25
11,ADDEPALLI VEERA VENKAT SUBBA RAO,Independent,2781,2,2783,0.23
12,ANAND CHANDULAL JASTI,Independent,2726,0,2726,0.22
13,GANJI PURNIMA,Republican Party of India (A),1645,4,1649,0.13
14,GEDALA LAXMANA RAO,Independent,1525,2,1527,0.12
15,ADDANKI DORABABU,Independent,1388,5,1393,0.11
16,GOTTUMUKKALA SHIVAJI,Independent,1378,6,1384,0.11
17,ADINARAYANA DUPPANAPUDI,Independent,1002,5,1007,0.08
18,MANNE LEELA RAMA NARENDRA,Pyramid Party of India,922,8,930,0.08
19,RAMA DURGA PRASAD THOLETI,Independent,919,1,920,0.07
20,RUKHMINI,Independent,683,3,686,0.06
21,ADABALA SIVA,Independent,682,1,683,0.06
22,NOTA,None of the Above,7554,123,7677,0.62
