S.No,Candidate,Party,EVM Votes,Postal Votes,Total Votes,Percentage of votes
1,Sasikanth Senthil,Indian National Congress,794608,2348,796956,56.21
2,"Balaganapathy, V. Pon",Bharatiya Janata Party,224042,759,224801,15.86
3,"Nallathambi, K.",Desiya Murpokku Dravida Kazhagam,223550,354,223904,15.79
4,"Jagadesh Chander, M.",Naam Tamilar Katchi,120620,218,120838,8.52
5,"Tamizhmadhi, D.",Bahujan Samaj Party,13772,38,13810,0.97
6,"Ashok Priyadarshan, S.",Desiya Makkal Sakthi Katchi,2937,9,2946,0.21
7,Malathi,Naadaalum Makkal Katchi,2829,24,2853,0.2
8,"Mani, E.",Independent,2745,7,2752,0.19
9,"Devandhran, M.",Anna MGR Dravida Makkal Kalgam,2001,7,2008,0.14
10,"Manimaran, V.",Independent,1921,1,1922,0.14
11,"Balakrishnan, K.",Independent,1685,5,1690,0.12
12,"Bharathidasan, S.S.",Independent,1619,12,1631,0.12
13,"Shakthivel, A.J.",Independent,1605,8,1613,0.11
14,"Sivasankaran, V.",Independent,1105,5,1110,0.08
15,NOTA,None of the Above,18908,70,18978,1.34
1,MANI. A.,Dravida Munnetra Kazhagam,429301,3366,432667,34.67
2,SOWMIYA ANBUMANI,Pattali Makkal Katchi,408445,2922,411367,32.97
3,ASOKAN. R. DR.,All India Anna Dravida Munnetra Kazhagam,291590,2039,293629,23.53
4,ABINAYA,Naam Tamilar Katchi,64576,805,65381,5.24
5,THANGAVEL. K.,Dhesiya Makkal Kazhagam,7323,8,7331,0.59
6,THIRUMURUGAN. P.,Independent,5668,3,5671,0.45
7,HARI. R.,Bahujan Samaj Party,3128,38,3166,0.25
8,SOWMIYA,Independent,3001,27,3028,0.24
9,ELAYARANI. P.,Ganasangam Party of India,2301,14,2315,0.19
10,ARUMUGAM. M.,Independent,2274,16,2290,0.18
11,AGNI AALVAR,Independent,1643,8,1651,0.13
12,PALANI. K.,Independent,1441,9,1450,0.12
13,MANI. R.,Independent,1029,4,1033,0.08
14,ASHOKAN. M.,Independent,1024,2,1026,0.08
15,ALAGARASAN. R.,Independent,899,1,900,0.07
16,SUNDHARAMOORTHY. M.,Independent,797,3,800,0.06
17,MANI. C.,Independent,706,4,710,0.06
18,PARTHASARATHI,Tamilar Makkal Katchi,698,11,709,0.06
19,PADMARAJAN. K. DR.,Independent,649,8,657,0.05
20,MANIVASAGAM. C.,Independent,648,3,651,0.05
21,ASOKAN. G.,Independent,609,2,611,0.05
22,AYYAKANNU,Independent,583,3,586,0.05
23,JAGANATHAN. A.,Independent,551,2,553,0.04
24,MANI. S.,Independent,451,1,452,0.04
25,NOTA,None of the Above,9093,105,9198,0.74
1,"ANNADURAI, C.N.",Dravida Munnetra Kazhagam,543857,3522,547379,47.75
2,KALIYAPERUMAL M,All India Anna Dravida Munnetra Kazhagam,311384,2064,313448,27.34
3,"ASUVATHAMAN, A.",Bharatiya Janata Party,154736,1914,156650,13.67
4,"RAMESHBABU, R.",Naam Tamilar Katchi,83148,721,83869,7.32
5,"KALIAPERUMAL, M.",Independent,5704,9,5713,0.5
6,"BENNYRAJAN, C.J.",Bharatiya Praja Aikyata Party,4703,107,4810,0.42
7,"KALIYAPERUMAL, A.",Independent,3402,5,3407,0.3
8,"MOHANRAJA, V.M.",Bahujan Samaj Party,2615,22,2637,0.23
9,CAPTAIN GOWTHAM,Independent,1823,19,1842,0.16
10,"UDHAYAKUMAR, P.S.",Independent,1246,5,1251,0.11
11,"ANNADURAI, S.",Independent,1165,7,1172,0.1
12,"KOTHANDABANI, B.",Independent,963,2,965,0.08
13,"SELVAM , K.",Veerath Thiyagi Viswanathadoss Thozhilalarkal Katchi,945,9,954,0.08
14,"KALASTHIRI, S.",All India Uzhavargal Uzhaippalargal Katchi,934,16,950,0.08
15,"VIJAYAKUMAR, S.",Independent,928,6,934,0.08
16,"JAGANNATHAN, R.",Independent,857,7,864,0.08
17,"SENTHAMIL SELVAN, M.",Independent,848,8,856,0.07
18,"AGNI SELVARASU, J.",Naadaalum Makkal Katchi,759,18,777,0.07
19,"SATHIYAMOORTHY, S.",Makkal Nala Kazhagam,716,20,736,0.06
20,"ANNADURAI, S.",Independent,642,6,648,0.06
21,"SUB MAJOR SETTU, M.",Viro Ke Vir Indian Party,636,22,658,0.06
22,"SANKAR, S.",Independent,569,9,578,0.05
23,"ANNADURAI, A.",Independent,482,34,516,0.05
24,"NALLASIVAM, M.",Independent,426,3,429,0.04
25,"PALANI , T.N.",Independent,413,1,414,0.04
26,"POONGODY, A.",Independent,412,5,417,0.04
27,"VIMAL, V.",Independent,341,1,342,0.03
28,"THANGARAJ, P.",Independent,291,4,295,0.03
29,"RAMESH , T.P.",Independent,280,1,281,0.02
30,"NAKKEERAN , A.",Independent,260,5,265,0.02
31,DEEPAMMAL SUNDARI,Independent,252,7,259,0.02
32,NOTA,None of the Above,11527,430,11957,1.04
1,THARANIVENTHAN M S,Dravida Munnetra Kazhagam,497083,3016,500099,43.86
2,"GAJENDRAN, G.V.",All India Anna Dravida Munnetra Kazhagam,289650,1683,291333,25.55
3,DR GANESH KUMAR A ME PHD,Pattali Makkal Katchi,234538,2033,236571,20.75
4,"BAKIYALAKSHMI, K.",Naam Tamilar Katchi,65981,759,66740,5.85
5,"MANIGANDAN, V.",Independent,4787,21,4808,0.42
6,"GANESH KUMAR, U.",Independent,3809,3,3812,0.33
7,DURAI M,Bahujan Samaj Party,3635,50,3685,0.32
8,"GAJENDRAN, J.",Independent,3393,7,3400,0.3
9,"KARVANNAN, K.",Independent,3032,4,3036,0.27
10,"GAJENDIRAN, E.",Independent,2612,1,2613,0.23
11,"KOTTAI VENKATESAN, M.",Independent,1893,15,1908,0.17
12,"SENTHIL KUMAR, D.",Independent,1469,6,1475,0.13
13,"SEKAR, N.",Independent,1397,3,1400,0.12
14,SAKTHIVEL A,Thakkam Katchi,1174,12,1186,0.1
15,"GANESH, P.",Independent,978,2,980,0.09
16,NAGARAJAN P,Veerath Thiyagi Viswanathadoss Thozhilalarkal Katchi,921,6,927,0.08
17,CAPTAIN SETTU M,Viro Ke Vir Indian Party,881,41,922,0.08
18,"JAISANKAR, M.",Independent,836,4,840,0.07
19,EZHIL ARASU M,Independent,741,12,753,0.07
20,BABU N,Independent,669,5,674,0.06
21,"DURUGAN, M.",United Republican Party of India,596,8,604,0.05
22,MOHMMAD SIDDIQ M H,Independent,525,3,528,0.05
23,"DHARANI, D.",Independent,466,2,468,0.04
24,"MANAVALAN, A.",Anna MGR Dravida Makkal Kalgam,433,47,480,0.04
25,"ARUL, M.",Independent,429,81,510,0.04
26,"MURUGESAN, D.",Independent,398,5,403,0.04
27,"ELLAPPAN, R.",Independent,375,3,378,0.03
28,"FEROZKHAN, A.",Independent,295,3,298,0.03
29,"DHAMODHARAN, G.",Independent,237,5,242,0.02
30,NOTA,None of the Above,9084,104,9188,0.81
1,RAVIKUMAR. D,Viduthalai Chiruthaigal Katchi,474230,2803,477033,41.39
2,BHAGYARAJ. J,All India Anna Dravida Munnetra Kazhagam,404503,1827,406330,35.25
3,MURALI SANKAR. S,Pattali Makkal Katchi,180020,1862,181882,15.78
4,KALANCHIYAM. M,Naam Tamilar Katchi,56766,476,57242,4.97
5,KARUNCHIRUTHAI KALIYAMURTHY. K,Bahujan Samaj Party,3883,37,3920,0.34
6,ARUMUGAM. M,United Republican Party of India,3487,17,3504,0.3
7,DHARMA. K,Independent,2375,7,2382,0.21
8,VIVEKANANDHAN. E,Independent,1945,8,1953,0.17
9,ARASAN. K,Independent,1835,7,1842,0.16
10,VIGNESVARAN. R,Independent,1643,13,1656,0.14
11,SURESH. S,Independent,1374,23,1397,0.12
12,PERIYAN. A,Independent,1041,8,1049,0.09
13,GUNASEKARAN. K,Independent,960,3,963,0.08
14,VIJAYAN. A,Independent,859,2,861,0.07
15,NAGARAJ. A,Independent,669,5,674,0.06
16,SURESH. K,Independent,592,6,598,0.05
17,SATHIYARAJ. N,Independent,412,3,415,0.04
18,NOTA,None of the Above,8874,92,8966,0.78
1,MALAIYARASAN D,Dravida Munnetra Kazhagam,558346,3243,561589,44.94
2,KUMARAGURU R,All India Anna Dravida Munnetra Kazhagam,505577,2228,507805,40.64
3,JAGADESAN A,Naam Tamilar Katchi,73098,554,73652,5.89
4,DEVADASS RAMASAMY,Pattali Makkal Katchi,70633,657,71290,5.71
5,PRABU C,Independent,4268,7,4275,0.34
6,BALAKRISHNAN P,Independent,3468,1,3469,0.28
7,JEEVANRAJ N,Bahujan Samaj Party,3075,21,3096,0.25
8,MAYILAMPARAI MARI A,Independent,2891,1,2892,0.23
9,NATTANMAI GUNASEKARANA A.S,Anna Makkal Katchi,2497,8,2505,0.2
10,KUMARAGURU N,Independent,2226,1,2227,0.18
11,MURUGESAN M,Independent,2223,2,2225,0.18
12,SUBRAMANIAN R K,Independent,868,4,872,0.07
13,ARUL INIYAN A,Independent,772,12,784,0.06
14,VENKATRAMAN J,Naadaalum Makkal Katchi,687,4,691,0.06
15,KAMALAKANNAN M,Independent,629,1,630,0.05
16,GOVINDARAJ S R,Independent,533,25,558,0.04
17,PALANIYAMMAL S,Desiya Makkal Sakthi Katchi,533,15,548,0.04
18,SIGAMANI A,Independent,515,27,542,0.04
19,RAJASEKAR K,Independent,501,10,511,0.04
20,JAYABAL PM,Independent,473,3,476,0.04
21,RAJAMANICKAM C,Independent,398,1,399,0.03
22,NOTA,None of the Above,8351,181,8532,0.68
1,SELVAGANAPATHI T M,Dravida Munnetra Kazhagam,562022,4063,566085,43.38
2,VIGNESH P,All India Anna Dravida Munnetra Kazhagam,492958,2770,495728,37.99
3,ANNADURAI N,Pattali Makkal Katchi,125829,1310,127139,9.74
4,DR MANOJKUMAR G,Naam Tamilar Katchi,75636,571,76207,5.84
5,BHALAJI M,Independent,3437,4,3441,0.26
6,MURALI S,Bahujan Samaj Party,3333,39,3372,0.26
7,PALANIVEL K,Independent,2853,3,2856,0.22
8,JEGANNATHAN A,Independent,2384,27,2411,0.18
9,RAJA S,Independent,1442,14,1456,0.11
10,MUTHUSAMY S,Independent,1193,4,1197,0.09
11,ER PRABAKARAN S,Independent,1151,4,1155,0.09
12,SHANMUGAM G,Independent,1144,3,1147,0.09
13,SANTHALINGAM C,Independent,1079,19,1098,0.08
14,SUTHARSANAM S,Aravor Munnetra Kazhagam,1030,6,1036,0.08
15,AMBEDKAR C,Ambedkarite Party of India,944,17,961,0.07
16,RAMACHANDRAN C,Dhesiya Makkal Kazhagam,748,10,758,0.06
17,GOVINDHAN A,Independent,686,7,693,0.05
18,MANICKAM R,Ulzaipali Makkal Katchy,533,4,537,0.04
19,AHAMED SHAHJAHAN M,Independent,453,13,466,0.04
20,INTHRAJITHKUPTHA G,Independent,425,7,432,0.03
21,RAMASUNDARAM D,Independent,419,3,422,0.03
22,KARUNAKARAN M,Independent,359,18,377,0.03
23,RAJA A,Independent,329,3,332,0.03
24,VIGNESH M,Independent,324,4,328,0.03
25,JOTHILINGAM M,Independent,314,2,316,0.02
26,NOTA,None of the Above,14677,217,14894,1.14
1,MATHESWARAN V S,Dravida Munnetra Kazhagam,457695,4341,462036,40.31
2,TAMILMANI S,All India Anna Dravida Munnetra Kazhagam,429358,3566,432924,37.77
3,DR RAMALINGAM K P,Bharatiya Janata Party,103577,1113,104690,9.13
4,KANIMOZHI G,Naam Tamilar Katchi,94895,682,95577,8.34
5,DEEPAN CHAKKRAVARTHI S,Independent,3546,33,3579,0.31
6,RAJENDRAN C,Viduthalai Kalam Katchi,2592,7,2599,0.23
7,NATARAJAN M,Independent,2565,23,2588,0.23
8,RAMESH T,Ahimsa Socialist Party,2412,9,2421,0.21
9,EZHIL SELVAN P,Tamilaga Makkal Thannurimai Katchi,2149,16,2165,0.19
10,RAMAN V,Bahujan Samaj Party,2137,20,2157,0.19
11,UTHAYAKUMAR P,Independent,1899,2,1901,0.17
12,KANDASAMY A M,Independent,1510,4,1514,0.13
13,RAMASAMY P,Independent,1338,12,1350,0.12
14,KARTHI S,Independent,1332,2,1334,0.12
15,RAMESH T R,Independent,1317,8,1325,0.12
16,SATHEESH G,Independent,1284,8,1292,0.11
17,RAMASAMY N,Independent,1243,7,1250,0.11
18,MADHESWARAN V,Independent,1144,3,1147,0.1
19,DR GURUNATHAN S,Independent,1048,23,1071,0.09
20,KARTHIKEYAN S,Independent,918,2,920,0.08
21,NALLATHAMBI P,Independent,769,1,770,0.07
22,EASWARAMOORTHY M,Independent,758,10,768,0.07
23,BALAJICHEZHIAN P,Independent,716,3,719,0.06
24,RAVIKUMAR P,Ganasangam Party of India,633,4,637,0.06
25,NAVEEN K,Independent,633,2,635,0.06
26,DURAIRAJ C,Independent,590,2,592,0.05
27,ARULMANI M,Independent,564,4,568,0.05
28,THIYAGARAJAN R,Samaniya Makkal Nala Katchi,527,1,528,0.05
29,VENNILA S,Independent,520,8,528,0.05
30,KALIANNAN S,Independent,496,1,497,0.04
31,KANDASAMY P,Independent,475,5,480,0.04
32,MANIKKAM S,Ulzaipali Makkal Katchy,439,3,442,0.04
33,MOORTHI J,Independent,385,4,389,0.03
34,TAMILMANI A,Independent,352,2,354,0.03
35,SELVARAJ K R,Independent,301,2,303,0.03
36,SAKTHIVEL S,Independent,298,1,299,0.03
37,NETAJIKAVIARASU V,Independent,287,1,288,0.03
38,SIVAKUMAR V,Independent,244,2,246,0.02
39,MOORTHY V,Independent,220,2,222,0.02
40,GOPAL P,Independent,214,0,214,0.02
41,NOTA,None of the Above,12736,248,12984,1.13
1,K E PRAKASH,Dravida Munnetra Kazhagam,558849,3490,562339,51.43
2,ASHOK KUMAR,All India Anna Dravida Munnetra Kazhagam,323751,2022,325773,29.79
3,KARMEGAN M,Naam Tamilar Katchi,82332,464,82796,7.57
4,P VIJAYAKUMAR,Tamil Maanila Congress (Moopanar),77319,592,77911,7.13
5,P ESWARAN,Bahujan Samaj Party,5161,62,5223,0.48
6,T V R AMIRTHALINGAM,Independent,4118,31,4149,0.38
7,KEERTHANA M,Independent,3775,24,3799,0.35
8,J GOPALAKRISHNAN,Independent,1949,6,1955,0.18
9,S ANANTHI,Independent,1683,3,1686,0.15
10,PRASATH CHITRARASU,Independent,1629,11,1640,0.15
11,RAVICHANDRAN L,Independent,1378,2,1380,0.13
12,P RAJENDRAN,Independent,973,3,976,0.09
13,P KUPPUSAMY,Ulzaipali Makkal Katchy,945,5,950,0.09
14,M SHANMUGAM,Independent,768,4,772,0.07
15,R KUMARESAN,Independent,744,7,751,0.07
16,N ASHOK KUMAR,Independent,689,1,690,0.06
17,DHANALAKSHMI V,Naadaalum Makkal Katchi,675,4,679,0.06
18,A T MUNUSAMY,Samaniya Makkal Nala Katchi,611,5,616,0.06
19,K MAATHAN,Ganasangam Party of India,609,9,618,0.06
20,B DHARMARAJ,Anti Corruption Dynamic Party,597,4,601,0.05
21,ARUMUGA AC KANNAN,Independent,547,2,549,0.05
22,M SABARINATHAN,Independent,525,6,531,0.05
23,R DHANDAPANI,Veerath Thiyagi Viswanathadoss Thozhilalarkal Katchi,502,2,504,0.05
24,R KUMAR,Anna Puratchi Thalaivar Amma Dravida Munnetra Kazhagam,424,8,432,0.04
25,R.MINNALMURUGESH,Independent,413,2,415,0.04
26,K K VADUGANATHAN,Independent,398,1,399,0.04
27,G MYLSAMY,Independent,301,0,301,0.03
28,MYLVAKANAN D -,Independent,276,3,279,0.03
29,M PRABAKARAN,Independent,274,2,276,0.03
30,NARENDRANATH,Independent,272,0,272,0.02
31,K SENTHIL KUMAR,Independent,177,1,178,0.02
32,NOTA,None of the Above,13742,241,13983,1.28
1,"SUBBARAYAN, K.",Communist Party of India,470195,2544,472739,41.38
2,"ARUNACHALAM, P.",All India Anna Dravida Munnetra Kazhagam,345326,1485,346811,30.35
3,"MURUGANANDAM, A.P.",Bharatiya Janata Party,184066,1256,185322,16.22
4,"SEETHALAKSHMI, M.K.",Naam Tamilar Katchi,95250,476,95726,8.38
5,"VELUSAMY, A.",Independent,7089,36,7125,0.62
6,"PALANI, V.",Bahujan Samaj Party,6013,41,6054,0.53
7,"SATHISHKUMAR, N.",Independent,2315,21,2336,0.2
8,"JANARTHANAM, P.",Tamilaga Makkal Thannurimai Katchi,1861,7,1868,0.16
9,"KANNAN, M.",Independent,1752,13,1765,0.15
10,"SENGUTTUVAN, M.R.",Independent,1560,7,1567,0.14
11,"SUBRAMANI, N.",Independent,1341,9,1350,0.12
12,"MALARVIZHI, G.",Rashtriya Samaj Paksha,1311,14,1325,0.12
13,"KARTHIKEYAN, P.",Independent,810,14,824,0.07
14,NOTA,None of the Above,17554,183,17737,1.55
1,RAJA A,Dravida Munnetra Kazhagam,470729,2483,473212,46.44
2,DR MURUGAN L,Bharatiya Janata Party,231111,1516,232627,22.83
3,LOGESH TAMILSELVAN D,All India Anna Dravida Munnetra Kazhagam,219417,813,220230,21.61
4,JAYAKUMAR A,Naam Tamilar Katchi,58588,233,58821,5.77
5,VIJAYAKUMAR D,Independent,4805,3,4808,0.47
6,GANESHAMOORTHI A,Bahujan Samaj Party,3015,18,3033,0.3
7,BADRAN M,Ganasangam Party of India,2406,19,2425,0.24
8,SELVAN N,Independent,2038,16,2054,0.2
9,DHANABAL R,Independent,1906,22,1928,0.19
10,JAYANTHI M,Ambedkarite Party of India,1539,17,1556,0.15
11,MURUGAN Y,Independent,1408,5,1413,0.14
12,MURUGESAN,Independent,1057,2,1059,0.1
13,MALARMANNAN M,Samaniya Makkal Nala Katchi,813,7,820,0.08
14,SATHISH M,Independent,734,6,740,0.07
15,KRISHNA KUMAR,Independent,588,27,615,0.06
16,ANBHUGURU V,Independent,560,5,565,0.06
17,NOTA,None of the Above,12902,98,13000,1.28
1,DR.KALANIDHI VEERASWAMY,Dravida Munnetra Kazhagam,495733,1600,497333,55.11
2,R. MANOHAR,All India Anna Dravida Munnetra Kazhagam,157631,480,158111,17.52
3,R.C. PAUL KANAGARAJ,Bharatiya Janata Party,112628,690,113318,12.56
4,AMUDINI,Naam Tamilar Katchi,95715,239,95954,10.63
5,SARAH FATHIMA,Independent,5899,24,5923,0.66
6,E. IQBAL,Bahujan Samaj Party,3471,15,3486,0.39
7,MOORTHY. V,Independent,3131,6,3137,0.35
8,SURIYAMUTHU,Independent,976,2,978,0.11
9,C. SENAPATHI,Independent,850,0,850,0.09
10,DILLI GANESH. E,Independent,735,1,736,0.08
11,U. VENKATESH,Independent,709,5,714,0.08
12,M. ZION RAJ,Independent,696,1,697,0.08
13,A. AJITHKUMAR,Thakkam Katchi,671,2,673,0.07
14,J. SEBASTIN,Socialist Unity Centre Of India (COMMUNIST),586,2,588,0.07
15,AKSHAY,Naadaalum Makkal Katchi,563,3,566,0.06
16,B. BALAMURUGAN,Independent,485,3,488,0.05
17,K.PALANIAPPAN,Independent,460,2,462,0.05
18,R. SENTHIL KUMAR,Independent,457,0,457,0.05
19,MATHANKUMAR. G,Independent,390,0,390,0.04
20,P. JAYASELAN,Independent,386,0,386,0.04
21,M. KOLANJI,Independent,361,1,362,0.04
22,B. ZAKIR HUSSAIN,Independent,354,1,355,0.04
23,P. UMADEVI,Independent,346,0,346,0.04
24,K.C.JAYAPRAKASH,Independent,334,0,334,0.04
25,C. SRIDHAR,Independent,307,0,307,0.03
26,T. MANOHARAN,Independent,293,0,293,0.03
27,K. SAMPATH,Independent,268,1,269,0.03
28,D. SRINIVASAN,Independent,260,1,261,0.03
29,S. RAVIKUMAR,Republican Party of India (Sivaraj),258,1,259,0.03
30,T. KAVIYARASU,Independent,250,2,252,0.03
31,SATHISH. B,Independent,245,1,246,0.03
32,R.VINAYAGAMOORTHY,Independent,206,0,206,0.02
33,D. KABILAN,Independent,203,6,209,0.02
34,P. MARIMUTHU,Independent,171,1,172,0.02
35,V.MADHAN MOHAN,Independent,163,0,163,0.02
36,NOTA,None of the Above,13139,69,13208,1.46
1,GANAPATHY RAJKUMAR P,Dravida Munnetra Kazhagam,565428,2772,568200,41.39
2,ANNAMALAI K,Bharatiya Janata Party,447608,2524,450132,32.79
3,SINGAI G RAMACHANDRAN,All India Anna Dravida Munnetra Kazhagam,235603,887,236490,17.23
4,KALAMANI JAGANATHAN,Naam Tamilar Katchi,82387,270,82657,6.02
5,VELMURUGAN K,Bahujan Samaj Party,2364,11,2375,0.17
6,SANJAYKUMAR S,Independent,1787,2,1789,0.13
7,ANNADURAI R,Independent,1767,5,1772,0.13
8,SURESH M,Independent,1472,2,1474,0.11
9,GOPALAKRISHNAN S,Independent,1196,3,1199,0.09
10,RAGHUL GANDHI K,Hindustan Janta Party,1170,6,1176,0.09
11,KARTHICK T,Independent,1070,3,1073,0.08
12,RAJKUMAR M,Independent,1067,1,1068,0.08
13,RAJKUMAR,Independent,1010,3,1013,0.07
14,RAJKUMAR G,Independent,888,4,892,0.06
15,SHANMUGAM K,Independent,881,1,882,0.06
16,KRISHNAN V,Independent,722,4,726,0.05
17,RAMACHANDRAN M,Independent,663,0,663,0.05
18,RAJAMANICKAM N,Independent,626,3,629,0.05
19,RAJKUMAR G B,Independent,607,4,611,0.04
20,KUMAR A,Ganasangam Party of India,548,3,551,0.04
21,SANGEETHA R,Naadaalum Makkal Katchi,491,1,492,0.04
22,RICHARD VINCENT,Viro Ke Vir Indian Party,489,3,492,0.04
23,SURIYAKUMAR K,Independent,443,4,447,0.03
24,ARUNKANTH V,Independent,432,6,438,0.03
25,ANANDHAKUMAR S,Rashtriya Samaj Paksha,417,2,419,0.03
26,RAMACHANDRAN R,Independent,368,1,369,0.03
27,MUTHUSAMY P P,Independent,368,1,369,0.03
28,PALANISAMYRAAJ M,Independent,313,3,316,0.02
29,PUSHPANANTHAM V,Tamizhaga Murpokku Makkal Katchi,303,2,305,0.02
30,DINESH K,Independent,284,1,285,0.02
31,PREMKUMAR P,Independent,281,2,283,0.02
32,RAVICHANDRAN,Independent,271,1,272,0.02
33,DURAISAMY A,Independent,263,3,266,0.02
34,ZAHIR HUSSAIN,Independent,259,1,260,0.02
35,BOOBALAN,Independent,252,1,253,0.02
36,NOORMUHAMAD A,Independent,232,2,234,0.02
37,PASUPATHI S,Independent,170,3,173,0.01
38,NOTA,None of the Above,11677,111,11788,0.86
1,ESWARASAMY K,Dravida Munnetra Kazhagam,530742,2635,533377,47.37
2,KARTHIKEYAN A,All India Anna Dravida Munnetra Kazhagam,280230,1105,281335,24.98
3,VASANTHARAJAN K,Bharatiya Janata Party,221945,1409,223354,19.84
4,SURESHKUMAR N,Naam Tamilar Katchi,57962,234,58196,5.17
5,PRAKASH P,Independent,2834,17,2851,0.25
6,BENJAMINKIRUBAKARAN J,Bahujan Samaj Party,2267,17,2284,0.2
7,VASANTHAKUMAR T,Independent,2186,4,2190,0.19
8,RAMASAMY K,Independent,1816,9,1825,0.16
9,ESWARASAMY K,Independent,1775,15,1790,0.16
10,GOPALAKRISHNAN M,New Generation People’s Party,1127,6,1133,0.1
11,KALIMUTHU S,Independent,976,5,981,0.09
12,KARTHIKEYAN D,Independent,600,19,619,0.05
13,NOOR MUHAMAD A,Independent,599,6,605,0.05
14,KARTHIKEYAN P,Independent,548,19,567,0.05
15,KARTHIKEYAN D,Independent,433,2,435,0.04
16,NOTA,None of the Above,14399,104,14503,1.29
1,SACHITHANANTHAM R,Communist Party of India (Marxist),667391,2758,670149,58.29
2,MOHAMED MUBARAK M A,All India Anna Dravida Munnetra Kazhagam,225492,836,226328,19.69
3,THILGABAMA M,Pattali Makkal Katchi,111013,1490,112503,9.79
4,KAILAI RAJAN D,Naam Tamilar Katchi,96891,954,97845,8.51
5,RAJKUMAR R,Independent,4410,6,4416,0.38
6,NATCHIMUTHU S,Bahujan Samaj Party,4231,53,4284,0.37
7,DINESHKUMAR S,All India Youth Development Party,2411,23,2434,0.21
8,MURUGESAN (A) VISHNU MURUGESAN C,Independent,2004,4,2008,0.17
9,ANGUCHAMY M,Independent,1286,4,1290,0.11
10,SURESH K,Independent,1254,3,1257,0.11
11,ARUMUGAM R,Independent,1078,11,1089,0.09
12,SABARINATH S,Independent,1001,10,1011,0.09
13,ANBUROSE D,Independent,997,15,1012,0.09
14,PALANISAMY K,Independent,941,8,949,0.08
15,SATHISH KANNA G T,Independent,914,12,926,0.08
16,NOTA,None of the Above,21860,260,22120,1.92
1,JOTHIMANI. S,Indian National Congress,531829,3077,534906,47.25
2,THANGAVEL. L,All India Anna Dravida Munnetra Kazhagam,366209,1881,368090,32.52
3,SENTHILNATHAN. V.V,Bharatiya Janata Party,101517,965,102482,9.05
4,KARUPPAIYA. R,Naam Tamilar Katchi,86962,541,87503,7.73
5,SANKARAN. S,Bahujan Samaj Party,2665,15,2680,0.24
6,SAKTHIVEL. R,Independent,2391,22,2413,0.21
7,ABILAZAN. N,Independent,1916,5,1921,0.17
8,KARTHIKPERUMAL. R,Independent,1808,1,1809,0.16
9,KATHIRAVAN. P,Independent,1445,3,1448,0.13
10,KARUNAMOORTHY. S,Independent,1278,0,1278,0.11
11,MOHAMED NAZEEM. S,Independent,938,0,938,0.08
12,PALANISAMY. N.A,Independent,934,0,934,0.08
13,SHANMUGAM. N,Samaniya Makkal Nala Katchi,924,5,929,0.08
14,KALAIRAJ. K,Independent,809,2,811,0.07
15,JOTHIMANI. A.K,Independent,805,3,808,0.07
16,KANNAN. T,Independent,782,6,788,0.07
17,JOTHIMANI. S,Independent,774,6,780,0.07
18,SATHASIVAM. R,Independent,728,1,729,0.06
19,MANIKANDAN. K,Independent,685,0,685,0.06
20,KOSAMALAR. P,Independent,641,3,644,0.06
21,MURUGESAN. K,Ganasangam Party of India,628,2,630,0.06
22,MAHESWARAN. A,Independent,589,1,590,0.05
23,REGIS THIYAGARAJAN. V.G.A,Independent,570,2,572,0.05
24,VINCENT. F,Anti Corruption Dynamic Party,510,5,515,0.05
25,NATRAYAN. R,Independent,503,0,503,0.04
26,BANUMATHY. S,Independent,494,2,496,0.04
27,UMADEVI. S,Independent,452,1,453,0.04
28,VARADAN. M,Independent,428,1,429,0.04
29,MURALI. M,Independent,417,0,417,0.04
30,SAKTHIVEL. N,Independent,414,1,415,0.04
31,BABU. G,Independent,387,0,387,0.03
32,JAFAR ALI. A,Independent,368,3,371,0.03
33,PRABHU. G,Independent,354,0,354,0.03
34,PALANIVEL. P,Independent,350,0,350,0.03
35,ANBAZHAGAN. T,Independent,338,1,339,0.03
36,MURUGESAN. P,Independent,327,0,327,0.03
37,SOWMIYA. R,Independent,307,3,310,0.03
38,SATHISHKUMAR. S,Independent,304,2,306,0.03
39,DHURAIYARASAN. P,Independent,273,2,275,0.02
40,VINOTH KUMAR. N,Independent,273,3,276,0.02
41,SATHIS KUMAR. C,Independent,258,9,267,0.02
42,THIRUGNANAM. M,Independent,253,5,258,0.02
43,SATHISH. P,Independent,241,3,244,0.02
44,MAHAMUNI. A,Independent,213,0,213,0.02
45,RAJAPANDIAN. K,Independent,207,2,209,0.02
46,JOTHIVEL. A,Independent,206,0,206,0.02
47,BASKARAN. N,Independent,205,0,205,0.02
48,PUSHPARAJ. N,Independent,199,0,199,0.02
49,NARENDRAKUMAR. G,Independent,197,0,197,0.02
50,PRASANTH. S,Independent,194,0,194,0.02
51,SUBASH MALAYALAM. T,Independent,186,0,186,0.02
52,NAGESVARAN. P,Independent,185,0,185,0.02
53,DANIYA. P,Independent,165,0,165,0.01
54,SIVAKUMAR. V,Independent,150,1,151,0.01
55,NOTA,None of the Above,8174,101,8275,0.73
1,DURAI VAIKO,Marumalarchi Dravida Munnetra Kazhagam,538877,3336,542213,51.35
2,KARUPPAIAH. P,All India Anna Dravida Munnetra Kazhagam,227445,1674,229119,21.7
3,RAJESSH. T,Naam Tamilar Katchi,106752,706,107458,10.18
4,SENTHILNATHAN. P,Amma Makkal Munnettra Kazagam,99561,1186,100747,9.54
5,SELVARAJ. S,Independent,14781,15,14796,1.4
6,DAMODARAN. S,Independent,5138,28,5166,0.49
7,ALLIMUTHU. M,Bahujan Samaj Party,4353,78,4431,0.42
8,RAJENDRAN. S,Independent,3489,10,3499,0.33
9,JEEVANANTHAM. M,Independent,2879,73,2952,0.28
10,SAKTHIVEL,Anna Puratchi Thalaivar Amma Dravida Munnetra Kazhagam,2587,59,2646,0.25
11,KARUPPIAH. S,Independent,2156,15,2171,0.21
12,BACKIYARAJ VELLAISAMY,Naadaalum Makkal Katchi,2120,163,2283,0.22
13,SATHIS KUMAR. S,Independent,2048,4,2052,0.19
14,KAVITHA. S,Independent,1719,17,1736,0.16
15,NAGARAJAN. M,Independent,1656,8,1664,0.16
16,GOVINDARASU. P,Independent,1562,4,1566,0.15
17,ANBIN AMUDHAN. R,Independent,1492,6,1498,0.14
18,DURAIRAJ. A,Independent,1455,8,1463,0.14
19,SASIKUMAR. P,Independent,1346,6,1352,0.13
20,PANNEERSELVAM. P,Independent,1255,8,1263,0.12
21,DURAI. S,Independent,1198,4,1202,0.11
22,ANAND SELVARAJ,Independent,1172,6,1178,0.11
23,SANKAR. R,Independent,1162,4,1166,0.11
24,AMBIVENKATESAN,Independent,972,6,978,0.09
25,DURAI. T,Independent,877,3,880,0.08
26,SATHYAMURTHY. T,Independent,826,8,834,0.08
27,VIJAYAKUMAR. P,Independent,797,5,802,0.08
28,PERIYASAMY. V,Independent,771,3,774,0.07
29,AKILA. M,Independent,742,5,747,0.07
30,ROJA RAMANI. S,Anna MGR Dravida Makkal Kalgam,738,39,777,0.07
31,RAJENDRAN. P,Independent,674,1,675,0.06
32,MANIKANDARAJ. S,Independent,601,7,608,0.06
33,MURUGESAN. P,Independent,494,3,497,0.05
34,JOSEPH. L,Samaniya Makkal Nala Katchi,482,9,491,0.05
35,MUTHURAJA. T,Independent,428,3,431,0.04
36,NOTA,None of the Above,13560,289,13849,1.31
1,ARUN NEHRU,Dravida Munnetra Kazhagam,598003,5206,603209,53.42
2,CHANDRAMOHAN N D,All India Anna Dravida Munnetra Kazhagam,212495,1607,214102,18.96
3,PAARIVENDHAR T R,Bharatiya Janata Party,160606,1260,161866,14.33
4,THENMOZHI R,Naam Tamilar Katchi,112200,892,113092,10.02
5,MANI S,Independent,3950,1,3951,0.35
6,MADHU R,Independent,3498,10,3508,0.31
7,RENGARAJ S,Independent,3251,22,3273,0.29
8,ELANGOVAN R,Bahujan Samaj Party,3033,26,3059,0.27
9,VASUDEVAN A,Independent,1355,7,1362,0.12
10,ARUN NEHRU,Independent,1280,19,1299,0.12
11,LAKSHMANAN,Independent,1087,0,1087,0.1
12,PARY T,Independent,1077,4,1081,0.1
13,ANANDARAJU R,Independent,1009,6,1015,0.09
14,JAYAKUMAR K,Samaniya Makkal Nala Katchi,1003,3,1006,0.09
15,TAMILSELVAN M,Independent,872,6,878,0.08
16,THANGAMANI K,Independent,868,5,873,0.08
17,P K AMMAN G SIVAKUMAR,Independent,740,15,755,0.07
18,EBINESAN M,Independent,731,17,748,0.07
19,MURUGANANTHAM T,Independent,730,3,733,0.06
20,SUDHAKAR S,Independent,550,5,555,0.05
21,SAMBATH D,Independent,530,2,532,0.05
22,MUTHUKUMAR,Independent,467,2,469,0.04
23,VEERAMALAI K,Independent,449,2,451,0.04
24,NOTA,None of the Above,10075,247,10322,0.91
1,M.K. VISHNUPRASAD,Indian National Congress,450401,4652,455053,44.11
2,P. SIVAKOZHUNDU,Desiya Murpokku Dravida Kazhagam,267707,1450,269157,26.09
3,THANKAR BACHAN,Pattali Makkal Katchi,202372,2872,205244,19.9
4,V. MANIVASAGAN,Naam Tamilar Katchi,56863,561,57424,5.57
5,S. ARIVUDAINAMBI,Anti Corruption Dynamic Party,6479,21,6500,0.63
6,A. BALAJI,Independent,5440,10,5450,0.53
7,V.THANIGAISELVAN,Bahujan Samaj Party,3917,54,3971,0.38
8,K. MAYAKRISHNAN,Veerath Thiyagi Viswanathadoss Thozhilalarkal Katchi,3696,6,3702,0.36
9,SU.VA. DHATSHANAMOORTHY,Independent,3414,5,3419,0.33
10,S. RAMALINGAM,Independent,3208,8,3216,0.31
11,G. PICHAMUTHU,Independent,2186,8,2194,0.21
12,R. ANANDHI,Independent,1677,19,1696,0.16
13,S. CHAKKARAVARTHY,Independent,1484,4,1488,0.14
14,R. SRINIVASAN,Independent,1352,11,1363,0.13
15,V. DAKSHANAAMURTHY,Independent,1276,10,1286,0.12
16,THANGA MURUGAN,Desiya Makkal Sakthi Katchi,1030,6,1036,0.1
17,R. RAJASEKAR,Independent,701,11,712,0.07
18,R. PRAKASH,Independent,694,6,700,0.07
19,S. RAJAMOHAN,Independent,659,1,660,0.06
20,NOTA,None of the Above,7084,208,7292,0.71
1,THIRUMAAVALAVAN THOL,Viduthalai Chiruthaigal Katchi,501851,3233,505084,43.28
2,CHANDRAHASAN M,All India Anna Dravida Munnetra Kazhagam,399502,2028,401530,34.4
3,KARTHIYAYINI P,Bharatiya Janata Party,166114,2379,168493,14.44
4,JANCIRANI R,Naam Tamilar Katchi,65116,473,65589,5.62
5,NEELAMEGAM K,Bahujan Samaj Party,3177,26,3203,0.27
6,TAMILVENDHAN P,Independent,3043,19,3062,0.26
7,PERUMAL S,Independent,2231,8,2239,0.19
8,VETTRIVEL G,Independent,2039,2,2041,0.17
9,ARCHUNAN M A T,Independent,1833,3,1836,0.16
10,DHAMODHARAN S,Naadaalum Makkal Katchi,1628,14,1642,0.14
11,RATHA G,Independent,1273,7,1280,0.11
12,RAJAMANICKAM C,Independent,1068,19,1087,0.09
13,CHINNADURAI A,Independent,628,10,638,0.05
14,ELAVARASAN C,Independent,584,2,586,0.05
15,NOTA,None of the Above,8631,130,8761,0.75
1,SUDHA R,Indian National Congress,516534,1925,518459,47.67
2,BABU P,All India Anna Dravida Munnetra Kazhagam,246083,1193,247276,22.73
3,STALIN M K,Pattali Makkal Katchi,165770,667,166437,15.3
4,KALIYAMMAL P,Naam Tamilar Katchi,127276,366,127642,11.73
5,KARTHICK A,Samaniya Makkal Nala Katchi,3888,3,3891,0.36
6,ILANCHEZHIAN T,Bahujan Samaj Party,2878,20,2898,0.27
7,BABU S,Independent,1832,6,1838,0.17
8,MANIMARAN T,Independent,1710,1,1711,0.16
9,NAGARAJAN K,Independent,1342,5,1347,0.12
10,SILAMBARASAN D,Independent,1255,1,1256,0.12
11,JAFARULLAH KHAN F,Independent,1230,6,1236,0.11
12,PANDIYARAJAN S,Independent,1169,5,1174,0.11
13,TIMOTHY T,Independent,1165,10,1175,0.11
14,VEDARETHINAM S,Anna MGR Dravida Makkal Kalgam,780,2,782,0.07
15,NITHIYANANTHAM S,Naadaalum Makkal Katchi,735,4,739,0.07
16,SRINIVASAN V,Independent,609,8,617,0.06
17,DHAKSHINAMOORTHY M,Independent,518,17,535,0.05
18,NOTA,None of the Above,8642,53,8695,0.8
1,SELVARAJ V,Communist Party of India,462759,2285,465044,47.79
2,DR SURSITH SANKAR G,All India Anna Dravida Munnetra Kazhagam,254676,1411,256087,26.32
3,KARTHIKA M,Naam Tamilar Katchi,130846,448,131294,13.49
4,RAMESHGOVIND S G M,Bharatiya Janata Party,101535,638,102173,10.5
5,VIJAYARAGAVAN N,Independent,3072,30,3102,0.32
6,SUBRAMANIAN K,Independent,2434,33,2467,0.25
7,JAGADEESH J BE,Bahujan Samaj Party,1789,17,1806,0.19
8,BOOMINATHAN B,Desiya Makkal Sakthi Katchi,1048,2,1050,0.11
9,PREM S,Independent,1047,23,1070,0.11
10,NOTA,None of the Above,8843,75,8918,0.92
1,T.SUMATHY (ALIAS) THAMIZHACHI THANGAPANDIAN,Dravida Munnetra Kazhagam,515307,1321,516628,47.0
2,DR.TAMILISAI SOUNDARARAJAN,Bharatiya Janata Party,289229,1454,290683,26.44
3,DR.J.JAYAVARDHAN,All India Anna Dravida Munnetra Kazhagam,172108,383,172491,15.69
4,S.TAMILCHELVI,Naam Tamilar Katchi,83821,151,83972,7.64
5,M.G.RAMU,Jebamani Janata,3526,8,3534,0.32
6,M.AZARUTHEEN,Independent,1808,4,1812,0.16
7,G.P. ROBERT,Bahujan Samaj Party,1596,3,1599,0.15
8,R.RAVICHANDRAN,Independent,835,0,835,0.08
9,S.MANIMARAN,Independent,803,0,803,0.07
10,FARMER JAYARAMAN. S.K.J,Desiya Makkal Sakthi Katchi,790,2,792,0.07
11,A.K.D. ELLAPPAN,Mahathma Makkal Munnetra Kazhakam,761,0,761,0.07
12,K.KANNAN,Independent,625,0,625,0.06
13,BALAJI. G. MANGADU,Aravor Munnetra Kazhagam,588,1,589,0.05
14,KUTTIMANI. S,Veerath Thiyagi Viswanathadoss Thozhilalarkal Katchi,565,0,565,0.05
15,R.KANCHANA,Tamizhaga Murpokku Makkal Katchi,565,1,566,0.05
16,SASI REKHA,Naadaalum Makkal Katchi,557,2,559,0.05
17,P. SATHEESH KUMAR,Independent,520,1,521,0.05
18,P.SEKAR,Thakkam Katchi,435,0,435,0.04
19,R.YOGESHWARAN,Independent,425,1,426,0.04
20,J. SATHISH,Independent,418,0,418,0.04
21,V.P. RAVIKKARAN,Independent,372,1,373,0.03
22,A.PONNUDURAI,Independent,362,0,362,0.03
23,N.V.DAMODARAN,National Maha Sabha Party,341,2,343,0.03
24,M.MUNUSWAMY,Viro Ke Vir Indian Party,326,4,330,0.03
25,KARTHIK MURTHY,Independent,312,3,315,0.03
26,V.P.SURESH,Independent,288,1,289,0.03
27,E.RAMESH,Independent,270,0,270,0.02
28,R.BALAJI,Independent,264,0,264,0.02
29,DINESH KUMAR. B,Independent,253,0,253,0.02
30,A.BABU,Independent,246,0,246,0.02
31,DAYALAN. R,Independent,241,1,242,0.02
32,VIJIRATHINAM. M,Independent,237,0,237,0.02
33,V.SIVAKUMAR,Independent,217,0,217,0.02
34,MURUGAN. P,Independent,182,0,182,0.02
35,G.RAMESHBABU,Independent,178,1,179,0.02
36,S.RAJASEKARAN,Independent,177,1,178,0.02
37,N.NARAYANASWAMY,Independent,175,0,175,0.02
38,R.DEVENDRAN,Independent,167,1,168,0.02
39,PARTHIBAN. S,Independent,165,1,166,0.02
40,I. DAVIDSINGH,Independent,150,1,151,0.01
41,E RAVENDRAN,Independent,114,0,114,0.01
42,NOTA,None of the Above,15607,46,15653,1.42
1,MURASOLI S,Dravida Munnetra Kazhagam,498822,3423,502245,48.82
2,SIVANESAN P,Desiya Murpokku Dravida Kazhagam,182172,490,182662,17.76
3,MURUGANANTHAM M,Bharatiya Janata Party,169587,1026,170613,16.59
4,HUMAYUN KABIR,Naam Tamilar Katchi,119683,610,120293,11.69
5,RENGASAMY C,Independent,18130,61,18191,1.77
6,SARAVANAN M,Independent,6730,65,6795,0.66
7,SENTHIL KUMAR N,Independent,4133,25,4158,0.4
8,EZHILARASAN S,Independent,3834,17,3851,0.37
9,JAYABAL A,Bahujan Samaj Party,2400,10,2410,0.23
10,SANTHOSH M,Independent,1982,10,1992,0.19
11,ER ARJUN S,Independent,1440,6,1446,0.14
12,KARIKALA CHOLAN S,Independent,1209,8,1217,0.12
13,NOTA,None of the Above,12674,159,12833,1.25
1,KARTI P CHIDAMBARAM,Indian National Congress,425631,2046,427677,40.6
2,XAVIERDASS A,All India Anna Dravida Munnetra Kazhagam,221255,758,222013,21.08
3,DHEVANATHAN YADAV T,Bharatiya Janata Party,194559,1229,195788,18.59
4,EZHILARASI,Naam Tamilar Katchi,162558,854,163412,15.51
5,DHANALAKSHMI M,Independent,8494,18,8512,0.81
6,GOVINDHARAJU M.G,Independent,4231,10,4241,0.4
7,NAGARAJAN KR,Independent,3682,14,3696,0.35
8,PALANIYAPPAN R,Independent,3426,1,3427,0.33
9,RANJITHKUMAR BALUSWAMY,Bahujan Samaj Party,3160,11,3171,0.3
10,BASKARAN S,Independent,2191,3,2194,0.21
11,KALAISELVAM K,Independent,1660,3,1663,0.16
12,MALAISAMY K,Independent,1524,3,1527,0.14
13,SEKAR A,Independent,1285,7,1292,0.12
14,SELVARAJ P,Independent,1108,3,1111,0.11
15,THILLAIVASAGAM M,Vidiyalai Thedum Indhiyargal Party,1068,5,1073,0.1
16,ASHOK KUMAR K,Independent,1030,4,1034,0.1
17,KARTHICK C,Independent,975,6,981,0.09
18,MUTHARASU PANDIYAN V,Independent,824,4,828,0.08
19,KALAIRAJA B,Independent,816,3,819,0.08
20,KARTHIKAIRAJAN P,Independent,762,9,771,0.07
21,NOTA,None of the Above,8119,70,8189,0.78
1,VENKATESAN S,Communist Party of India (Marxist),428201,2122,430323,43.6
2,RAAMA SREENIVASAN,Bharatiya Janata Party,219035,1879,220914,22.38
3,SARAVANAN P,All India Anna Dravida Munnetra Kazhagam,204163,641,204804,20.75
4,SATHYADEVI T,Naam Tamilar Katchi,92386,493,92879,9.41
5,VELMURUGAN A,Bharatiya Praja Aikyata Party,5966,43,6009,0.61
6,VENKATESAN M,Independent,2497,8,2505,0.25
7,RAMAR PANDI T,Bahujan Samaj Party,2489,17,2506,0.25
8,SHANMUGA SUNDARAM A,United Republican Party of India,2338,11,2349,0.24
9,PERIYASAMY K,Independent,1966,2,1968,0.2
10,PANDIYAN S,Bahujan Dravida Party,1559,3,1562,0.16
11,BOOMINATHAN C,Independent,1211,2,1213,0.12
12,MUTHUPANDI S,Independent,1206,1,1207,0.12
13,RAMANATHAN S,Independent,1191,3,1194,0.12
14,VENKATESH S,Independent,1041,5,1046,0.11
15,SANKARAPANDI M.P.,Independent,1025,4,1029,0.1
16,GOPISON M.M.,Independent,942,4,946,0.1
17,SARAVANAN K.K.,Independent,843,1,844,0.09
18,GOPALAKRISHNAN S,Independent,745,1,746,0.08
19,CHANDRASEKAR N,Independent,708,3,711,0.07
20,PANDIYAN P,Socialist Unity Centre Of India (COMMUNIST),576,2,578,0.06
21,AVADAINATHAN V,Independent,461,1,462,0.05
22,NOTA,None of the Above,11074,100,11174,1.13
1,THANGA TAMILSELVAN,Dravida Munnetra Kazhagam,569110,2383,571493,50.08
2,TTV DHINAKARAN,Amma Makkal Munnettra Kazagam,289909,2759,292668,25.65
3,NARAYANASAMY V T,All India Anna Dravida Munnetra Kazhagam,154871,716,155587,13.63
4,MADHAN,Naam Tamilar Katchi,75495,1339,76834,6.73
5,PRAKASH P,Independent,6293,5,6298,0.55
6,PANDIKUMAR S,Independent,3907,60,3967,0.35
7,AJEETHKUMAR S,Independent,2977,29,3006,0.26
8,PARAMASIVAN S,Independent,2852,14,2866,0.25
9,PARTHIBAN G,Independent,2275,2,2277,0.2
10,JEEVA M,Bahujan Samaj Party,2123,99,2222,0.19
11,CHARCHIL DURAI P,Humanity for Peace Party,1905,30,1935,0.17
12,PREMA S,Independent,1225,7,1232,0.11
13,MANIKANDAN R,Independent,1195,6,1201,0.11
14,REVATHI K,Independent,1115,13,1128,0.1
15,MUDIYARASU,All India Youth Development Party,1078,16,1094,0.1
16,THIAGARAJAN O V,Independent,924,8,932,0.08
17,VASANTHA SARAVANAN,Independent,803,2,805,0.07
18,VIJAYAN K,Independent,665,2,667,0.06
19,SETHUPATHI G,Independent,613,4,617,0.05
20,JOHNGILBERTRAJ,Independent,598,5,603,0.05
21,AATHIMUTHUKUMAR M,Independent,587,5,592,0.05
22,MUTHUKUMAR,Independent,539,4,543,0.05
23,HARIKRISHNAKUMAR R,Independent,481,5,486,0.04
24,SATHEESH KUMAR A,Independent,447,6,453,0.04
25,KUMAR,Independent,376,1,377,0.03
26,NOTA,None of the Above,11206,130,11336,0.99
1,MANICKAM TAGORE B,Indian National Congress,382876,2380,385256,36.28
2,VIJAYAPRABHAKARAN V,Desiya Murpokku Dravida Kazhagam,378243,2634,380877,35.87
3,RADIKAA R,Bharatiya Janata Party,164149,2122,166271,15.66
4,KAUSHIK S,Naam Tamilar Katchi,76122,909,77031,7.25
5,RAJESH,Independent,6167,6,6173,0.58
6,ASHOK KUMAR M,Bharatiya Praja Aikyata Party,5228,65,5293,0.5
7,SEKAR S,Hindu Samaj Party,3436,10,3446,0.32
8,MANIKANDAN M,Independent,3341,5,3346,0.32
9,MAYAK KANNAN,Independent,2749,2,2751,0.26
10,MAHENDRA RAMAKRISHNAN P,Independent,2404,1,2405,0.23
11,SURESH,Bahujan Samaj Party,2378,19,2397,0.23
12,SELVI K,Independent,2165,23,2188,0.21
13,PANDIYAMMAL R,Independent,2128,5,2133,0.2
14,SUDALAIMANI M,Independent,1357,2,1359,0.13
15,PALANICHAMY P,Bahujan Dravida Party,1261,2,1263,0.12
16,PALANISAMY K,Independent,1251,6,1257,0.12
17,VENKATESWARAN V K,Independent,1242,5,1247,0.12
18,SELVARAJAN V V,Independent,1120,1,1121,0.11
19,MARIEESWARI M,Independent,1100,10,1110,0.1
20,SANKARANARAYANAN N,Independent,994,4,998,0.09
21,SELVAKUMAR M,Independent,896,6,902,0.08
22,MUTHUKANNU C,Tamilaga Makkal Nala Katchi,753,8,761,0.07
23,MARISELVAM S,All India People Development Party,708,3,711,0.07
24,JEYARAJ T,Independent,602,8,610,0.06
25,VEDHA @ DHAMODHARAN,Independent,599,1,600,0.06
26,RAJAGOPAL S,Independent,525,2,527,0.05
27,GANESHAMOORTHI G,Independent,457,3,460,0.04
28,NOTA,None of the Above,9256,152,9408,0.89
1,NAVASKANI K,Indian Union Muslim League,506690,2974,509664,45.92
2,PANNEERSELVAM O S/O OTTAKARATHEVAR,Independent,340778,2104,342882,30.89
3,JEYAPERUMAL P,All India Anna Dravida Munnetra Kazhagam,98757,1023,99780,8.99
4,DR CHANDRA PRABHA JEYAPAL,Naam Tamilar Katchi,96701,971,97672,8.8
5,MUVITH KUMAR N,Independent,7901,18,7919,0.71
6,SENTHILMALLAR K,Independent,6629,198,6827,0.62
7,SIVASHANKAR N,Independent,6583,10,6593,0.59
8,KANNADHASAN R,Independent,3485,17,3502,0.32
9,SELVARAJ G,Puthiya Makkal Tamil Desam Katchi,2943,14,2957,0.27
10,PANNEERSELVAM O S/O OCHAPPAN,Independent,2939,42,2981,0.27
11,PANCHAVARNAM V,Independent,2561,11,2572,0.23
12,PARIRAJAN C,Veerath Thiyagi Viswanathadoss Thozhilalarkal Katchi,2493,4,2497,0.22
13,PANNIR SELVAM M S/O MALAIYANDI,Independent,2387,15,2402,0.22
14,NAWASKHAN,Independent,2301,22,2323,0.21
15,SIVANANDAM N,Bahujan Samaj Party,1958,56,2014,0.18
16,PANNEERSELVAM O S/O OYYADEVAR,Independent,1920,9,1929,0.17
17,ABUBAKKAR SITHICK J,Desiya Makkal Sakthi Katchi,1497,21,1518,0.14
18,MANIVASAGAM S,Bahujan Dravida Party,1392,11,1403,0.13
19,PANNEERSELVAM O S/O OYYARAM,Independent,1369,7,1376,0.12
20,SALEEM,Independent,961,13,974,0.09
21,SASIKANI K,Independent,896,3,899,0.08
22,SATHURAGIRI K,Independent,815,12,827,0.07
23,SIKKANDAR B,Independent,804,19,823,0.07
24,VIGNESH V,Independent,643,9,652,0.06
25,PANNERSELVAM O S/O OCHATTHEVAR,Independent,564,8,572,0.05
26,NOTA,None of the Above,6163,132,6295,0.57
1,KANIMOZHI KARUNANIDHI,Dravida Munnetra Kazhagam,537879,2850,540729,55.26
2,SIVASAMY VELUMANI R,All India Anna Dravida Munnetra Kazhagam,147407,584,147991,15.12
3,VIJAYASEELAN SDR,Tamil Maanila Congress (Moopanar),121680,700,122380,12.51
4,ROWENA RUTH JANE J,Naam Tamilar Katchi,119374,926,120300,12.29
5,RAJHA N P,Naam Indiar Party,6622,18,6640,0.68
6,ARUNADEVI R,Independent,6029,43,6072,0.62
7,CHITHIRAI JEGAN S,Independent,3637,3,3640,0.37
8,SIVANESWARAN J,Independent,3363,13,3376,0.35
9,SAMUEL T,Independent,2240,5,2245,0.23
10,MANIKKARAJ A,Bahujan Samaj Party,2158,37,2195,0.22
11,AASIRIYAR SHANMUGA SUNDARAM K,Independent,1832,7,1839,0.19
12,KALEERMURUGAPAVENTHAN R,Makkal Nalvaazhvuk Katchi,1736,56,1792,0.18
13,PONKUMARAN T P S,Independent,894,3,897,0.09
14,JEYAKUMAR C,Independent,825,4,829,0.08
15,GANDHIMALLAR S M,Independent,791,14,805,0.08
16,BISHOP DR GODFREY NOBLE,Aanaithinthiya Jananayaka Pathukappu Kazhagam,757,12,769,0.08
17,PERUMALKUMAR P,Puthiya Makkal Tamil Desam Katchi,727,12,739,0.08
18,ESAKKIMUTHU V,Independent,699,11,710,0.07
19,KANNAN G,Independent,679,10,689,0.07
20,DAVID JEBASEELAN J,Independent,656,7,663,0.07
21,SUDALAIMUTHU P,Independent,576,2,578,0.06
22,KRISHNAN S,Independent,479,1,480,0.05
23,RADHAKRISHNAN V G,Independent,456,5,461,0.05
24,JAMES P,Independent,433,11,444,0.05
25,PONRAJ K,Independent,428,1,429,0.04
26,PRASANNA KUMAR M,Independent,396,0,396,0.04
27,SELVAMUTHUKUMAR M,Independent,341,0,341,0.03
28,SENTHIL KUMAR S,Independent,290,1,291,0.03
29,NOTA,None of the Above,9682,124,9806,1.0
1,DR RANI SRI KUMAR,Dravida Munnetra Kazhagam,423025,2654,425679,40.97
2,DR K KRISHNASAMY,All India Anna Dravida Munnetra Kazhagam,228290,1190,229480,22.08
3,B JOHN PANDIAN,Bharatiya Janata Party,206982,1843,208825,20.1
4,ESAI MATHIVANAN,Naam Tamilar Katchi,128750,1585,130335,12.54
5,KARPAGAVALLI P,Independent,6200,114,6314,0.61
6,T MAHESHKUMAR,Bahujan Samaj Party,3526,28,3554,0.34
7,RAMASAMY P,Viro Ke Vir Indian Party,3395,17,3412,0.33
8,M MANMATHAN,Independent,3276,2,3278,0.32
9,A SEETHA,Bahujan Dravida Party,2476,0,2476,0.24
10,KRISHNASAMY,Independent,1828,5,1833,0.18
11,M UMAMAHESWARI,Desiya Makkal Sakthi Katchi,1626,29,1655,0.16
12,A MUTHAIAH,Independent,1440,17,1457,0.14
13,P KRISHNASAMY,Independent,1342,8,1350,0.13
14,ARUMUGASWAMI M,Independent,1292,21,1313,0.13
15,RAJA SEKAR,Independent,982,11,993,0.1
16,NOTA,None of the Above,16877,288,17165,1.65
1,ROBERT BRUCE C,Indian National Congress,499493,2803,502296,47.06
2,NAINAR NAGENTHRAN,Bharatiya Janata Party,334431,2245,336676,31.54
3,JANSI RANI M,All India Anna Dravida Munnetra Kazhagam,88996,605,89601,8.39
4,SATHYA,Naam Tamilar Katchi,86918,768,87686,8.21
5,POTTAL SUNDARA MUNISWARAN,Independent,19802,50,19852,1.86
6,ATHISAYAM V,Independent,3744,37,3781,0.35
7,BALASUBRAMANIAN,Bahujan Samaj Party,2044,23,2067,0.19
8,CHINNA MAHARAJA K,Independent,1888,7,1895,0.18
9,DAVID M,Independent,1829,7,1836,0.17
10,SAMUEL LAWRENCE PONNIAH,Independent,1493,4,1497,0.14
11,BISHOP DR GODFREY WASHINGTON NOBLE,Aanaithinthiya Jananayaka Pathukappu Kazhagam,1457,18,1475,0.14
12,LENIN K,Independent,1441,9,1450,0.14
13,CHANDRAN M,Veerath Thiyagi Viswanathadoss Thozhilalarkal Katchi,1409,4,1413,0.13
14,SELVA KUMAR S,Bahujan Dravida Party,1317,29,1346,0.13
15,KUMAR V,Puthiya Makkal Tamil Desam Katchi,1057,15,1072,0.1
16,MUTHURAMAN A,Aravor Munnetra Kazhagam,1046,2,1048,0.1
17,THALAPATHY MURUGAN M,Independent,913,4,917,0.09
18,SIVARAM K,Independent,855,20,875,0.08
19,RAMAKRISHNAN N,Nam India Naam Indiyar Katchi,790,0,790,0.07
20,SURESH,Independent,777,11,788,0.07
21,DR RAJENDRA RETNAM K,Independent,685,4,689,0.06
22,SEVAL KANNAN B ADVOCATE,Independent,622,14,636,0.06
23,RAGHAVAN C M,Independent,364,2,366,0.03
24,NOTA,None of the Above,7285,111,7396,0.69
1,VIJAYAKUMAR (Alias) VIJAY VASANTH,Indian National Congress,540267,5981,546248,53.08
2,RADHAKRISHNAN P,Bharatiya Janata Party,361623,4718,366341,35.6
3,MARIA JENNIFER CLARA MICHAEL,Naam Tamilar Katchi,51893,828,52721,5.12
4,PASILIAN NAZERATH,All India Anna Dravida Munnetra Kazhagam,40927,466,41393,4.02
5,NAGOOR MEERAN PEER MOHAMED U,Independent,4412,3,4415,0.43
6,BERRILA L,Independent,3256,6,3262,0.32
7,BALASUBRAMANIAN T,Independent,2047,25,2072,0.2
8,VIJAYAN G,Bahujan Samaj Party,1607,16,1623,0.16
9,DENNISON V,Independent,1274,4,1278,0.12
10,DR TOM MANOHAR C M,Punnagai Desam Party,1034,6,1040,0.1
11,SATHISH BABU P,Independent,747,1,748,0.07
12,RAJAN SINGH,Bahujan Dravida Party,592,6,598,0.06
13,GEETA M,Thakkam Katchi,528,24,552,0.05
14,SANTHAKUMAR N,Independent,521,6,527,0.05
15,RAMESHKUMAR J L,Independent,464,1,465,0.05
16,ESAKKIMUTHU N,Independent,435,6,441,0.04
17,AYYAPPAN V,Independent,358,15,373,0.04
18,SARAVANAN N,Samaniya Makkal Nala Katchi,308,7,315,0.03
19,VINO JEBA SEELAN T,Independent,265,5,270,0.03
20,KRISHNAN P,Independent,250,4,254,0.02
21,VENKADESH S C,Independent,187,1,188,0.02
22,ANTONY MICHAEL J,Independent,166,9,175,0.02
23,NOTA,None of the Above,3680,76,3756,0.36
1,DAYANIDHI MARAN,Dravida Munnetra Kazhagam,412286,1562,413848,56.65
2,VINOJ,Bharatiya Janata Party,168059,1100,169159,23.16
3,B. PARTHASARATHY,Desiya Murpokku Dravida Kazhagam,71772,244,72016,9.86
4,DR.R.KARTHIKEYAN,Naam Tamilar Katchi,45865,166,46031,6.3
5,ANBAZHAGAN.G,Independent,3175,11,3186,0.44
6,DILAVAR ALI,Tipu Sultan Party,2536,10,2546,0.35
7,SAMARAN,Bahujan Samaj Party,2132,15,2147,0.29
8,L.KASINATHAN,Independent,1059,1,1060,0.15
9,AGNI AALVAR,Independent,783,4,787,0.11
10,C.S.KARNAN,Anti Corruption Dynamic Party,750,11,761,0.1
11,M.L.RAVI,Desiya Makkal Sakthi Katchi,690,6,696,0.1
12,S.KANDASAMY,Independent,595,1,596,0.08
13,DHAYANIDHI SURESH,Independent,565,2,567,0.08
14,S.SATHISH KUMAR,Independent,526,1,527,0.07
15,P.ARJUNAN,Independent,502,7,509,0.07
16,S.SATHISH KUMAR,Independent,500,1,501,0.07
17,G.OMPRAKASH,Independent,486,2,488,0.07
18,V.V.TAMILARASAN,Independent,386,3,389,0.05
19,UDAYA KUMAR.V,Independent,382,0,382,0.05
20,B.PARTHASARATHY,Independent,377,3,380,0.05
21,K.CHANDRASEKAR,Naadaalum Makkal Katchi,373,0,373,0.05
22,N.RAMAN,Tamilnadu Makkal Nalvazhvu Periyakkam,311,3,314,0.04
23,R.MINNAL RAJ,Independent,310,0,310,0.04
24,R.VIJAY,Independent,268,0,268,0.04
25,A.SELVA KUMAR,Thakkam Katchi,265,5,270,0.04
26,M.NAGARAJ,Independent,254,0,254,0.03
27,J.NAGARAJ,Independent,238,3,241,0.03
28,SENTHILKUMAR,Chennai Youth Party,222,1,223,0.03
29,RANJITHKUMAR.S,Independent,215,0,215,0.03
30,RAVI BALARAMAN,Independent,182,1,183,0.03
31,MANJUNATHA.R,Independent,159,0,159,0.02
32,NOTA,None of the Above,11082,81,11163,1.53
1,T R BAALU,Dravida Munnetra Kazhagam,755671,2940,758611,52.65
2,G PREMKUMAR,All India Anna Dravida Munnetra Kazhagam,270549,1033,271582,18.85
3,V N VENUGOPAL,Tamil Maanila Congress (Moopanar),209183,927,210110,14.58
4,V RAVICHANDRAN,Naam Tamilar Katchi,139931,302,140233,9.73
5,K PRABAKARAN,Bahujan Samaj Party,8115,74,8189,0.57
6,M S ARUMUGAM,Independent,3695,4,3699,0.26
7,V SUDHAVALLI,Aravor Munnetra Kazhagam,3659,35,3694,0.26
8,S AMBETHKUMAR,Mahathma Makkal Munnetra Kazhakam,2211,9,2220,0.15
9,M ASHOK KUMAR,Independent,1696,8,1704,0.12
10,S SIVAKUMAR,Veerath Thiyagi Viswanathadoss Thozhilalarkal Katchi,1349,3,1352,0.09
11,AYODHI LAKSHMANAN,Independent,1255,4,1259,0.09
12,S CHITTIBABU,Naadaalum Makkal Katchi,1238,3,1241,0.09
13,C ARAVIND,Desiya Makkal Sakthi Katchi,959,11,970,0.07
14,GOPI DEEPAK,Independent,878,5,883,0.06
15,KARTHIK KUMAR P C,Independent,866,1,867,0.06
16,J MOHANRAJ,Jebamani Janata,817,5,822,0.06
17,DR S PRAVEEN,Independent,791,8,799,0.06
18,I MOHAMED YASEEN,Thakkam Katchi,668,1,669,0.05
19,K PALANIYAPPAN,Tamizhaga Murpokku Makkal Katchi,613,4,617,0.04
20,S PRABHU,Independent,513,1,514,0.04
21,P BASKARAN,Independent,493,1,494,0.03
22,P HARIDAS,Independent,458,2,460,0.03
23,C A JAYARAMAN,Independent,445,2,447,0.03
24,G RAMKUMAR,Independent,426,0,426,0.03
25,N MANIKKAM,Independent,402,1,403,0.03
26,M PREMKUMAR,Independent,393,1,394,0.03
27,S MUNIKUMAR,Samaniya Makkal Nala Katchi,393,1,394,0.03
28,M SARAVANAN,Independent,385,0,385,0.03
29,A JINNA MOHAMMED,Independent,382,6,388,0.03
30,S SIVARAMAN,Independent,340,3,343,0.02
31,C PREMKUMAR,Independent,313,3,316,0.02
32,NOTA,None of the Above,26294,156,26450,1.84
1,SELVAM. G,Dravida Munnetra Kazhagam,582978,3066,586044,46.53
2,RAJASEKAR. E,All India Anna Dravida Munnetra Kazhagam,362991,1580,364571,28.94
3,JOTHI. V,Pattali Makkal Katchi,163792,1139,164931,13.09
4,SANTHOSH KUMAR. V,Naam Tamilar Katchi,109858,414,110272,8.75
5,ILAYARAJA. S,Bahujan Samaj Party,5243,21,5264,0.42
6,VENKATESAN. K,Independent,2798,9,2807,0.22
7,NARESH BHARATHI. S,Independent,2499,12,2511,0.2
8,ELANGOVAN. M,Independent,1874,7,1881,0.15
9,SURYA. A,Independent,1673,29,1702,0.14
10,RAMESH. S,Independent,1317,1,1318,0.1
11,SELVAM. T,Independent,1295,17,1312,0.1
12,NOTA,None of the Above,16811,154,16965,1.35
1,S JAGATHRATCHAKAN,Dravida Munnetra Kazhagam,560578,2638,563216,48.39
2,L VIJAYAN,All India Anna Dravida Munnetra Kazhagam,255343,1314,256657,22.05
3,K BALU,Pattali Makkal Katchi,200614,1711,202325,17.38
4,S AFSHIA NASRIN,Naam Tamilar Katchi,97985,959,98944,8.5
5,D PANDIYAN,Bahujan Samaj Party,6135,77,6212,0.53
6,A PALANI,Independent,3855,11,3866,0.33
7,K MANIGANDAN,Independent,2045,4,2049,0.18
8,INDU W,Tamil Manila Murpokku Dravida Kazhagam,1872,66,1938,0.17
9,DR A V NARENDRAN,Independent,1711,11,1722,0.15
10,M VIJAYAN,Independent,1674,4,1678,0.14
11,M BALU,Independent,1557,4,1561,0.13
12,SHETTU S,Independent,1556,5,1561,0.13
13,V BABU,United Republican Party of India,1351,15,1366,0.12
14,M THULASIRAMAN,Independent,1046,7,1053,0.09
15,D JANAKIRAMAN,Independent,831,6,837,0.07
16,S SURESH KUMAR,Independent,828,7,835,0.07
17,R VINOTH,Veerath Thiyagi Viswanathadoss Thozhilalarkal Katchi,819,2,821,0.07
18,V VINAYAGAM,Independent,727,2,729,0.06
19,VIJAYAN K,All India Jananayaka Makkal Kazhagam,624,9,633,0.05
20,SHANAVAS J,Independent,580,3,583,0.05
21,V KRISHNANANDAN,Anna MGR Dravida Makkal Kalgam,568,14,582,0.05
22,A JAYACHANDRAN,Independent,534,4,538,0.05
23,N SUGUMAR,Independent,424,8,432,0.04
24,M VIJAY,Independent,416,11,427,0.04
25,G SUDHAKAR,Independent,367,13,380,0.03
26,K VENKATESAN,Independent,261,3,264,0.02
27,NOTA,None of the Above,12423,190,12613,1.08
1,DM KATHIR ANAND,Dravida Munnetra Kazhagam,566435,2257,568692,50.35
2,AC SHANMUGAM,Bharatiya Janata Party,350956,2034,352990,31.25
3,DR S PASUPATHI,All India Anna Dravida Munnetra Kazhagam,116964,718,117682,10.42
4,D MAHESH ANAND,Naam Tamilar Katchi,52707,577,53284,4.72
5,A NATARAJAN,Bharatiya Praja Aikyata Party,3982,23,4005,0.35
6,SHANMUGAVELU,Independent,3570,6,3576,0.32
7,MANSOOR ALI KHAN,Independent,2769,35,2804,0.25
8,SYED ALI D,Independent,2121,3,2124,0.19
9,P SHANMUGAM,Independent,2037,2,2039,0.18
10,NAGARAJ P,Independent,1948,11,1959,0.17
11,K JAYAMANI,Bahujan Samaj Party,1684,18,1702,0.15
12,D SARAVANAN,Independent,1497,0,1497,0.13
13,MP SHANMUGAM,Independent,859,9,868,0.08
14,N SIVAKUMAR,Independent,701,0,701,0.06
15,AFROSE,Independent,672,1,673,0.06
16,A BEEMARAO MILINTHAR,United Republican Party of India,667,3,670,0.06
17,DR S JAYARAJ,Independent,659,2,661,0.06
18,K SHANMUGAM,Independent,601,15,616,0.05
19,V KALIAPERUMAL,Ganasangam Party of India,594,6,600,0.05
20,G SHANMUGAM,Independent,560,12,572,0.05
21,PP JAYAPRAKASH,Independent,455,6,461,0.04
22,PASUPATHI,Independent,407,8,415,0.04
23,S WILLIAM SATHYARAJ,Tamil Manila Murpokku Dravida Kazhagam,373,4,377,0.03
24,M BABU,Independent,303,3,306,0.03
25,B JAGAN,Independent,282,3,285,0.03
26,AHMED RAASHID PALLIMIRA,Independent,271,2,273,0.02
27,SHANMUGASUNDARAM,Independent,250,1,251,0.02
28,C MADHAVAN,Independent,201,1,202,0.02
29,T JOHNSON,Independent,174,0,174,0.02
30,E RAJKUMAR,Independent,129,4,133,0.01
31,C RAMACHANDHIRAN,Independent,128,2,130,0.01
32,NOTA,None of the Above,8669,67,8736,0.77
1,GOPINATH K,Indian National Congress,491131,1752,492883,42.27
2,JAYAPRAKASH V,All India Anna Dravida Munnetra Kazhagam,299300,1097,300397,25.76
3,NARASIMHAN C,Bharatiya Janata Party,212859,1266,214125,18.36
4,VIDHYA RANI,Naam Tamilar Katchi,106260,823,107083,9.18
5,ARUMUGAM M,Bharatiya Praja Aikyata Party,6118,36,6154,0.53
6,DR.SHANMUGAM .A.R,Independent,5577,6,5583,0.48
7,ESHWARAN C,Independent,4126,2,4128,0.35
8,TAMILSELVAN S,Bahujan Samaj Party,3665,33,3698,0.32
9,SWAMINATHAN T G,Aravor Munnetra Kazhagam,1969,9,1978,0.17
10,MANI K,Chennai Youth Party,1964,8,1972,0.17
11,SRINIVASAN K,Independent,1619,2,1621,0.14
12,VENKATESHKUMAR M,Independent,1585,5,1590,0.14
13,ALBERT FRANCIS XAVIER S,Independent,1422,1,1423,0.12
14,SARAVANAKUMAR A,Independent,1163,6,1169,0.1
15,ANAND KUMAR A,Independent,1157,3,1160,0.1
16,SUBRAMANI M,Tamilar Makkal Katchi,1156,39,1195,0.1
17,ANNADURAI K,Independent,1154,6,1160,0.1
18,MAHARAJAN G,Independent,991,4,995,0.09
19,JAGADHEESAN C,Viro Ke Vir Indian Party,897,3,900,0.08
20,VIJAYAKUMAR K P,Anaithu India Makkal Katchi,891,46,937,0.08
21,DEEKSHITH M,Karunaadu Party,817,7,824,0.07
22,RAMESH A,Independent,816,3,819,0.07
23,RAJESHWARI B.H.,Independent,793,6,799,0.07
24,CHANDRAMOHAN K.M.,Independent,789,3,792,0.07
25,DEVAPPA Y,Independent,717,7,724,0.06
26,VEERASAMY C,Independent,656,4,660,0.06
27,YUVARAJ K P U,Independent,402,3,405,0.03
28,NOTA,None of the Above,10893,89,10982,0.94
