S.No,Candidate,Party,EVM Votes,Postal Votes,Total Votes,Percentage of votes
1,JAGADISH CHANDRA BARMA BASUNIA,All India Trinamool Congress,785747,2628,788375,48.57
2,NISITH PRAMANIK,Bharatiya Janata Party,745144,3981,749125,46.16
3,NITISH CHANDRA ROY,All India Forward Bloc,29992,275,30267,1.86
4,PIYA ROY CHOWDHURY,Indian National Congress,10539,140,10679,0.66
5,HAREKRISHNA SARKAR,Independent,9462,5,9467,0.58
6,KAMALESH BARMAN,Independent,2972,21,2993,0.18
7,NABI BARMAN,Independent,2710,14,2724,0.17
8,SUBODH BARMAN,Independent,2594,5,2599,0.16
9,DILIP CHANDRA BARMAN,Socialist Unity Centre Of India (COMMUNIST),2449,19,2468,0.15
10,PURNA MOHAN ROY,Bahujan Samaj Party,2087,10,2097,0.13
11,BIDHAN DAS,Independent,2067,5,2072,0.13
12,KISHORE RAY,Independent,1588,18,1606,0.1
13,PRADIP KUMAR ROY,Kamatapur People’s Party (United),1499,19,1518,0.09
14,AMAL DAS,Independent,1488,7,1495,0.09
15,NOTA,None of the Above,15510,53,15563,0.96
1,PATHAN YUSUF,All India Trinamool Congress,523630,886,524516,37.88
2,ADHIR RANJAN CHOWDHURY,Indian National Congress,438171,1323,439494,31.74
3,DR. NIRMAL KUMAR SAHA,Bharatiya Janata Party,370370,1515,371885,26.86
4,SAMIRAN DAS,Independent,18526,1,18527,1.34
5,SWAPAN KUMAR MANDAL,Independent,6394,2,6396,0.46
6,SANTOSH BISWAS,Bahujan Samaj Party,4219,19,4238,0.31
7,BISWAMVOIR KALITA,Independent,3060,2,3062,0.22
8,SOMNATH PAUL,All India Arya Mahasabha,2250,0,2250,0.16
9,RUNA LAILA,Social Democratic Party Of India,1569,2,1571,0.11
10,ABHIJIT MANDAL,Socialist Unity Centre Of India (COMMUNIST),1410,8,1418,0.1
11,ASHIS DAS,Independent,1106,4,1110,0.08
12,ADHIR SWARNAKAR,Independent,851,5,856,0.06
13,AJIT KUMAR MANDAL,Independent,745,4,749,0.05
14,MANIK KUMAR DAS,Jai Prakash Janata Dal,729,0,729,0.05
15,AABDUSA SATTAR SEKH,Indian National Socialistic Action Forces,477,7,484,0.03
16,NOTA,None of the Above,7474,11,7485,0.54
1,ABU TAHER KHAN,All India Trinamool Congress,681674,768,682442,44.27
2,MD SALIM,Communist Party of India (Marxist),517733,494,518227,33.62
3,GOURI SANKAR GHOSH,Bharatiya Janata Party,291013,1018,292031,18.94
4,HABIB SAIKH,All India Secular Front,12359,11,12370,0.8
5,ASIM RAY,Bhartiya Lokmat Rashtrwadi Party,5522,12,5534,0.36
6,SAHABUDDIN MALLIK,Independent,4156,0,4156,0.27
7,RAFIKUL ISLAM,Independent,4064,1,4065,0.26
8,MAHAFUJUL ALAM,Socialist Unity Centre Of India (COMMUNIST),3423,3,3426,0.22
9,MD TAIEDUL ISLAM,Social Democratic Party Of India,3291,2,3293,0.21
10,DHANANJOY SARKAR,Independent,1535,4,1539,0.1
11,KRISHNA PROSAD BISWAS,Independent,1197,9,1206,0.08
12,NOTA,None of the Above,13249,21,13270,0.86
1,MAHUA MOITRA,All India Trinamool Congress,624711,4078,628789,44.1
2,AMRITA ROY,Bharatiya Janata Party,567628,4456,572084,40.13
3,S.M. SADI,Communist Party of India (Marxist),179063,1138,180201,12.64
4,SANJIT BISWAS,Independent,8660,11,8671,0.61
5,SOURAV HELA,Independent,5061,4,5065,0.36
6,NEMAI BISWAS,Independent,5047,22,5069,0.36
7,AMAL CHANDRA SARKAR,Bahujan Samaj Party,5045,55,5100,0.36
8,AFROJA KHATUN MONDAL,All India Secular Front,4284,14,4298,0.3
9,ISMAT ARA MONDAL,Socialist Unity Centre Of India (COMMUNIST),3603,19,3622,0.25
10,MD. MUKTAR SHAIKH,Independent,3287,7,3294,0.23
11,ALIK KUMAR KUNDU,Independent,2699,9,2708,0.19
12,NOTA,None of the Above,6754,57,6811,0.48
1,JAGANNATH SARKAR,Bharatiya Janata Party,778046,4350,782396,50.78
2,MUKUT MANI ADHIKARI,All India Trinamool Congress,592276,3221,595497,38.65
3,ALAKESH DAS,Communist Party of India (Marxist),122970,840,123810,8.04
4,BIPLAB BISWAS,Bahujan Samaj Party,9319,73,9392,0.61
5,PARESH HALDAR,Socialist Unity Centre Of India (COMMUNIST),8223,16,8239,0.53
6,JAGANNATH SARKAR,Independent,5831,30,5861,0.38
7,SHYAMAL KUMAR MALLICK,Independent,5533,11,5544,0.36
8,NOTA,None of the Above,9798,95,9893,0.64
1,SHANTANU THAKUR,Bharatiya Janata Party,716952,2553,719505,48.19
2,BISWAJIT DAS S/O LATE BIJAY KRISHNA DAS,All India Trinamool Congress,643653,2159,645812,43.25
3,PRADIPKUMAR BISWAS,Indian National Congress,64859,317,65176,4.37
4,DIPAK MAJUMDAR,All India Secular Front,19199,17,19216,1.29
5,SUJATA BAIRAGI,Independent,9649,4,9653,0.65
6,JASHAJIT SARKHEL,Independent,7829,4,7833,0.52
7,CHANDAN MALLICK,Bahujan Samaj Party,5905,30,5935,0.4
8,PRANITA MANDAL,Independent,2407,4,2411,0.16
9,SUMITA PODDAR,Independent,2347,7,2354,0.16
10,BISWAJIT DAS S/O LATE BALARAM DAS,Independent,2241,7,2248,0.15
11,PATIT PABAN MANDAL,Socialist Unity Centre Of India (COMMUNIST),2140,29,2169,0.15
12,SAMARESH BISWAS,Party for Democratic Socialism,1562,3,1565,0.1
13,BISWAJIT DAS,Independent,1257,15,1272,0.09
14,KALYAN SARKAR,Independent,676,15,691,0.05
15,SUBRATA BISWAS,Guruchand Sena Dal,581,2,583,0.04
16,NOTA,None of the Above,6635,50,6685,0.45
1,PARTHA BHOWMICK,All India Trinamool Congress,518486,1745,520231,45.56
2,ARJUN SINGH,Bharatiya Janata Party,454184,1609,455793,39.92
3,DEBDUT GHOSH,Communist Party of India (Marxist),109038,526,109564,9.6
4,MD JAMIR HOSSAIN,All India Secular Front,18797,9,18806,1.65
5,ROHIT KUMAR PATHAK,Independent,7116,16,7132,0.62
6,CHAPALA RAY (MAJUMDER),Bahujan Samaj Party,3882,27,3909,0.34
7,SHARMISTHA DAS,Independent,3622,12,3634,0.32
8,ANJAN GOSWAMI,Bharatiya Nyay-Adhikar Raksha Party,3434,14,3448,0.3
9,DHARMENDRA SINGH,Independent,2843,4,2847,0.25
10,SANJAY SINGH,Independent,1670,6,1676,0.15
11,DEBASISH BANERJEE,Socialist Unity Centre Of India (COMMUNIST),1422,12,1434,0.13
12,KUNDAN SINGH,Independent,820,6,826,0.07
13,UDAY VEER CHOUDHURY,Independent,745,12,757,0.07
14,AMIT KUMAR CHOUBEY,Independent,717,4,721,0.06
15,NOTA,None of the Above,11043,39,11082,0.97
1,SOUGATA RAY,All India Trinamool Congress,526289,2290,528579,41.95
2,SILBHADRA DATTA,Bharatiya Janata Party,456138,1781,457919,36.34
3,SUJAN CHAKRABORTY,Communist Party of India (Marxist),239418,1366,240784,19.11
4,SHEKH IMANUR RAHMAN,Independent,6410,1,6411,0.51
5,SWAMINATH KORI,Bahujan Samaj Party,3749,17,3766,0.3
6,HIRAK SINHA,Independent,3144,3,3147,0.25
7,BANAMALI PANDA,Socialist Unity Centre Of India (COMMUNIST),1728,11,1739,0.14
8,DULU DEY,Independent,1688,6,1694,0.13
9,MANIKA MUKHERJEE,Bharatiya Nyay-Adhikar Raksha Party,1231,6,1237,0.1
10,SANTANU MANDAL,Democratic Socialist Party of India,880,5,885,0.07
11,TRIDIB BHUNIA,Independent,765,7,772,0.06
12,GOURI BISWAS,Independent,698,3,701,0.06
13,SUBRATA BHOWMIK,Mera Bharat Mahan Party,602,2,604,0.05
14,HARI PADA BISWAS,Mulnibasi Party of India,465,9,474,0.04
15,NOTA,None of the Above,11256,78,11334,0.9
1,KAKOLI GHOSH DASTIDAR,All India Trinamool Congress,689513,2497,692010,45.15
2,SWAPAN MAJUMDER,Bharatiya Janata Party,576024,1797,577821,37.7
3,TAPAS BANERJEE,All India Secular Front,121355,85,121440,7.92
4,SANJIB CHATTERJEE,All India Forward Bloc,99456,544,100000,6.52
5,SMRITIKANA HAOLADAR,Bahujan Samaj Party,5759,28,5787,0.38
6,SAIFUDDIN MONDAL,Independent,3823,4,3827,0.25
7,SWAPAN MAJUMDAR,Independent,3083,2,3085,0.2
8,S MUKHTAR AHMED,Independent,2639,8,2647,0.17
9,SEFALI DEY,Bharatiya Nyay-Adhikar Raksha Party,2244,8,2252,0.15
10,SADHAN GHOSH,Socialist Unity Centre Of India (COMMUNIST),2025,22,2047,0.13
11,BIKASH SARKAR,Mulnibasi Party of India,1928,1,1929,0.13
12,MOHAN LAL ADHIKARY,Independent,1850,14,1864,0.12
13,NOTA,None of the Above,17834,58,17892,1.17
1,SK NURUL ISLAM,All India Trinamool Congress,801542,2220,803762,52.76
2,REKHA PATRA,Bharatiya Janata Party,468593,1622,470215,30.87
3,AKHTAR RAHAMAN BISWAS,All India Secular Front,123432,68,123500,8.11
4,NIRAPADA SARDAR,Communist Party of India (Marxist),77611,288,77899,5.11
5,MAFIJUL MOLLA,Independent,11833,0,11833,0.78
6,PRIYAMA DAS,Independent,6606,14,6620,0.43
7,MIRAZ MOLLA,Independent,5902,0,5902,0.39
8,MD ABUL KALAM MOLLA,Bahujan Samaj Party,4451,13,4464,0.29
9,BIDYUT GAYEN,Independent,3625,9,3634,0.24
10,IMRAN ALI SARDAR,Bharatheeya Jawan Kisan Party,2548,5,2553,0.17
11,PIYARUL ISLAM,Independent,2388,3,2391,0.16
12,SARAVAN SINGH,Independent,2020,1,2021,0.13
13,DAUD ALI GAZI,Socialist Unity Centre Of India (COMMUNIST),1163,4,1167,0.08
14,KINKAR KANTI ROY,Independent,1115,3,1118,0.07
15,BIPUL CHANDRA BISWAS,Mulnibasi Party of India,1070,4,1074,0.07
16,NOTA,None of the Above,5229,19,5248,0.34
1,PRATIMA MONDAL,All India Trinamool Congress,891053,3259,894312,60.32
2,ASHOK KANDARY,Bharatiya Janata Party,422546,1547,424093,28.6
3,MEGHNATH HALDER,All India Secular Front,65316,56,65372,4.41
4,SAMARENDRA NATH MONDAL,Revolutionary Socialist Party,39927,186,40113,2.71
5,NIRANJAN NASKAR,Socialist Unity Centre Of India (COMMUNIST),14547,75,14622,0.99
6,SUJAN SARDAR,Independent,10779,15,10794,0.73
7,SINDHUPADA BAIRAGI,Independent,9150,12,9162,0.62
8,SHANKAR DEB MONDAL,Bahujan Samaj Party,6363,28,6391,0.43
9,JURAN CHANDRA PANDEY,Mulnibasi Party of India,3750,19,3769,0.25
10,MILAN NASKAR,Independent,2129,7,2136,0.14
11,PRATIMA MONDAL,Independent,2052,27,2079,0.14
12,NOTA,None of the Above,9756,32,9788,0.66
1,MANOJ TIGGA,Bharatiya Janata Party,691533,3781,695314,48.92
2,PRAKASH CHIK BARAIK,All India Trinamool Congress,617486,2381,619867,43.61
3,MILI ORAON,Revolutionary Socialist Party,39424,285,39709,2.79
4,PARIMAL ORAON,Independent,12560,24,12584,0.89
5,ARJUN INDWAR,Independent,11090,32,11122,0.78
6,MUNIB NARJINARY,Bahujan Samaj Party,6600,48,6648,0.47
7,RAHUL MARAK,Kisan Mazdoor Sangharsh Party,5679,16,5695,0.4
8,CHANDAN ORAON,Socialist Unity Centre Of India (COMMUNIST),2751,36,2787,0.2
9,BINAY MURMU,North Bengal People’s Party,2700,58,2758,0.19
10,NRIPENDRA NARAYAN DEBKARJEE,Kamatapur People’s Party (United),2017,38,2055,0.14
11,BABITA BARA,Gana Suraksha Party,1522,30,1552,0.11
12,NOTA,None of the Above,21235,63,21298,1.5
1,BAPI HALDAR,All India Trinamool Congress,752486,3245,755731,50.52
2,ASHOK PURKAIT,Bharatiya Janata Party,552798,1876,554674,37.08
3,AJAY KUMAR DAS,All India Secular Front,87530,76,87606,5.86
4,DR SARAT CHANDRA HALDER,Communist Party of India (Marxist),60778,322,61100,4.08
5,BAPI HALDER,Independent,8922,12,8934,0.6
6,BAPI HALDAR,Independent,5607,19,5626,0.38
7,BISWANATH SARDAR,Socialist Unity Centre Of India (COMMUNIST),4505,29,4534,0.3
8,PANKAJ KUMAR HALDER,Bahujan Samaj Party,4238,19,4257,0.28
9,ASHOKE PUROKAIT,Independent,1489,12,1501,0.1
10,ASHOKE SARDAR,Independent,1474,27,1501,0.1
11,BAPPA DAS,Party for Democratic Socialism,1203,6,1209,0.08
12,RUDRA PRASAD MANDAL,Mulnibasi Party of India,707,13,720,0.05
13,NOTA,None of the Above,8593,38,8631,0.58
1,ABHISHEK BANERJEE,All India Trinamool Congress,1043493,4737,1048230,68.48
2,ABHIJIT DAS (BOBBY),Bharatiya Janata Party,336068,1232,337300,22.03
3,PRATIK UR RAHAMAN,Communist Party of India (Marxist),86507,446,86953,5.68
4,MAJNU LASKAR,All India Secular Front,21109,30,21139,1.38
5,SUBRATA BOSE,Independent,9819,6,9825,0.64
6,DASARATHI PAIK,Bahujan Samaj Party,7082,29,7111,0.46
7,MALAY GUHA ROY,Independent,2963,8,2971,0.19
8,PULAKESH MONDAL,Independent,1945,3,1948,0.13
9,KALIMUDDIN SK,Indian National Socialistic Action Forces,1579,11,1590,0.1
10,RAMKUMAR MONDAL,Socialist Unity Centre Of India (COMMUNIST),1411,7,1418,0.09
11,ANISUR RAHAMAN SK,Independent,1152,7,1159,0.08
12,KASHINATH MONDAL,Independent,961,24,985,0.06
13,NOTA,None of the Above,10134,54,10188,0.67
1,SAYANI GHOSH,All India Trinamool Congress,714049,3850,717899,45.83
2,DR. ANIRBAN GANGULY,Bharatiya Janata Party,457307,2391,459698,29.35
3,SRIJAN BHATTACHARYYA,Communist Party of India (Marxist),256951,1761,258712,16.52
4,NUR ALAM KHAN,All India Secular Front,83291,71,83362,5.32
5,RANJIT KUMAR MANDAL,Independent,13021,9,13030,0.83
6,HOSEN GAZI,Independent,4925,2,4927,0.31
7,SANDIP NATH,Bahujan Samaj Party,4434,28,4462,0.28
8,KALPANA NASKAR DATTA,Socialist Unity Centre Of India (COMMUNIST),4416,35,4451,0.28
9,BALARAM MANDAL,Independent,2829,6,2835,0.18
10,TANUSHREE MONDAL,Independent,2419,8,2427,0.15
11,SHANKAR MANDAL,Independent,1439,3,1442,0.09
12,SRI GOPAN SARDAR,Mulnibasi Party of India,1366,7,1373,0.09
13,PURNIMA DEBNATH,Independent,1301,24,1325,0.08
14,CHANDRACHUR GOSWAMI,Independent,1112,2,1114,0.07
15,ARUN SARKAR,Independent,1107,3,1110,0.07
16,DIPAK SARDAR,Independent,924,3,927,0.06
17,NOTA,None of the Above,7316,99,7415,0.47
1,MALA ROY,All India Trinamool Congress,612725,2549,615274,49.48
2,DEBASREE CHAUDHURI,Bharatiya Janata Party,426459,1584,428043,34.42
3,SAIRA SHAH HALIM,Communist Party of India (Marxist),167771,760,168531,13.55
4,NIRAJ AGARWAL,Independent,4028,4,4032,0.32
5,FIROZA KHATUN,Bahujan Samaj Party,3958,17,3975,0.32
6,SANTANU ROY,Independent,2918,2,2920,0.23
7,ZUBAIR RABBANI,Socialist Unity Centre Of India (COMMUNIST),2290,10,2300,0.18
8,SUSANTA MONDAL,Independent,2090,1,2091,0.17
9,MUMTAZ ALI,Independent,1960,9,1969,0.16
10,MUKTI,Right to Recall Party,1537,7,1544,0.12
11,SANJOY (RANA) CHANDA,Kisan Mazdoor Sangharsh Party,1186,7,1193,0.1
12,SANJANA RAM,Independent,1052,4,1056,0.08
13,YASMIN ISLAM,Social Democratic Party Of India,981,4,985,0.08
14,ATANU DAS,Independent,969,2,971,0.08
15,MRIDUL OJHA,Independent,856,6,862,0.07
16,DIPENDU HAZRA,Independent,794,10,804,0.06
17,MD. SHAKIL WARSI,Independent,503,1,504,0.04
18,NOTA,None of the Above,6348,75,6423,0.52
1,BANDYOPADHYAY SUDIP,All India Trinamool Congress,453177,1519,454696,47.44
2,TAPAS ROY,Bharatiya Janata Party,361268,868,362136,37.78
3,PRADIP BHATTACHARYA,Indian National Congress,114556,426,114982,12.0
4,DR. BIPLAB CHANDRA,Socialist Unity Centre Of India (COMMUNIST),3640,18,3658,0.38
5,OMPRAKASH PRAJAPATI,Bahujan Samaj Party,3133,47,3180,0.33
6,PRANATI PAUL,Independent,2267,5,2272,0.24
7,SURENDRA KUMAR KABRA,Independent,1317,5,1322,0.14
8,SWAPAN DAS,Independent,1163,3,1166,0.12
9,MISBAHUS SALAM,Independent,975,6,981,0.1
10,SAMPA GUHA,Bharatiya Nyay-Adhikar Raksha Party,912,4,916,0.1
11,RAJKUMAR PALIT,Mission Naya Digant Party,768,4,772,0.08
12,SMT. RINKU GUPTA,Pyramid Party of India,649,10,659,0.07
13,AMAL KUMAR DEY,Independent,582,9,591,0.06
14,ANUJIT KUMAR NAN,Independent,555,2,557,0.06
15,BINOY KRISHNA CHATTERJEE,Independent,500,1,501,0.05
16,NOTA,None of the Above,10004,40,10044,1.05
1,PRASUN BANERJEE,All India Trinamool Congress,625229,1264,626493,49.26
2,DR RATHIN CHAKRAVARTY,Bharatiya Janata Party,455996,1055,457051,35.94
3,SABYASACHI CHATTERJEE,Communist Party of India (Marxist),151483,522,152005,11.95
4,PALASH BACHAR,Bahujan Samaj Party,6342,12,6354,0.5
5,SEIKH SAKIRUL ISLAM,Independent,5271,0,5271,0.41
6,SHIWA MALLICK,Independent,3218,2,3220,0.25
7,UTTAM CHATTERJEE,Socialist Unity Centre Of India (COMMUNIST),2319,6,2325,0.18
8,SHAMPA DAS,Bharatiya Nyay-Adhikar Raksha Party,2053,12,2065,0.16
9,RATHIN GANGULY,Independent,1884,3,1887,0.15
10,PRASUN LAHIRI,Independent,1323,3,1326,0.1
11,RAJESH KUMAR PRASAD,All India Arya Mahasabha,1268,4,1272,0.1
12,ADARSHA MONDAL,Independent,939,6,945,0.07
13,AJAZ AHMED ANSARI,Independent,856,1,857,0.07
14,TAPAS BARUI,Independent,637,4,641,0.05
15,NOTA,None of the Above,10036,48,10084,0.79
1,SAJDA AHMED,All India Trinamool Congress,722586,2036,724622,52.1
2,ARUNUDAY PAULCHOWDHURY,Bharatiya Janata Party,504611,1338,505949,36.38
3,AZAHAR MOLLICK,Indian National Congress,78304,285,78589,5.65
4,MOFIKUL ISLAM,All India Secular Front,38971,20,38991,2.8
5,ARIT KARAK,Independent,7287,5,7292,0.52
6,AMAL KUMAR DEYATI,Bharatiya Nyay-Adhikar Raksha Party,5445,6,5451,0.39
7,RAMESH KHANRA,Independent,5094,10,5104,0.37
8,BIMALESH KUMAR HELA,Bahujan Samaj Party,4867,8,4875,0.35
9,SK. SAPIYAR ALI,Independent,2924,0,2924,0.21
10,NIKHIL BERA,Socialist Unity Centre Of India (COMMUNIST),2095,12,2107,0.15
11,AMAL KUMAR BARMAN,Independent,1997,3,2000,0.14
12,RAMPRASAD GHORAI,Indian Unity Centre,1568,4,1572,0.11
13,NOTA,None of the Above,11263,55,11318,0.81
1,KALYAN BANERJEE,All India Trinamool Congress,671865,2105,673970,45.65
2,KABIR SHANKAR BOSE,Bharatiya Janata Party,497720,1420,499140,33.8
3,DIPSITA DHAR,Communist Party of India (Marxist),238131,1015,239146,16.2
4,SAHARIAR MULLICK (BAPI),All India Secular Front,25659,18,25677,1.74
5,SUNDAR PATRA,Independent,9897,5,9902,0.67
6,SASANKA CHAKRABORTY,Independent,3933,5,3938,0.27
7,SUPRIYA BISWAS,Bahujan Samaj Party,3572,17,3589,0.24
8,KALYAN PAUL,Independent,1749,9,1758,0.12
9,PRADYUT CHOWDHURI,Socialist Unity Centre Of India (COMMUNIST),1671,9,1680,0.11
10,KALYAN SAMANTA,Independent,1421,19,1440,0.1
11,SARKAR MANGAL,Bahujan Maha Party,1256,2,1258,0.09
12,NOTA,None of the Above,14964,70,15034,1.02
1,RACHNA BANERJEE,All India Trinamool Congress,700120,2624,702744,46.31
2,LOCKET CHATTERJEE,Bharatiya Janata Party,623867,2024,625891,41.24
3,MANADIP GHOSH,Communist Party of India (Marxist),139250,669,139919,9.22
4,SURAJIT HEMBRAM,Independent,9257,11,9268,0.61
5,SAMIM ALI MOLLICK,Independent,6555,12,6567,0.43
6,JAMINI BHAR,Bahujan Samaj Party,4684,34,4718,0.31
7,AJANTA SARKAR,Bharatiya National Janata Dal,3619,20,3639,0.24
8,SK KAMALUDDIN,Independent,2755,11,2766,0.18
9,SANCHITA BERA,Independent,2632,17,2649,0.17
10,PABAN MAZUMDER,Socialist Unity Centre Of India (COMMUNIST),2367,13,2380,0.16
11,PRADIP PAL,Bharatiya Nyay-Adhikar Raksha Party,2205,15,2220,0.15
12,MRINAL KANTI DAS,Independent,1387,11,1398,0.09
13,NOTA,None of the Above,13250,102,13352,0.88
1,BAG MITALI,All India Trinamool Congress,710432,2155,712587,45.71
2,ARUP KANTI DIGAR,Bharatiya Janata Party,704124,2064,706188,45.3
3,BIPLAB KUMAR MOITRA,Communist Party of India (Marxist),92073,429,92502,5.93
4,RAGHU MALLIK,Independent,16123,7,16130,1.03
5,SUBIR KUMAR ROY,Bahujan Samaj Party,3807,24,3831,0.25
6,VASKAR MALIK,Independent,3662,3,3665,0.24
7,SUKANTA POREL,Socialist Unity Centre Of India (COMMUNIST),1807,9,1816,0.12
8,BABLU GHANTI,Independent,1610,19,1629,0.1
9,ABHIJIT MAJI,Independent,1600,6,1606,0.1
10,ALOK DOLAI,Independent,1081,13,1094,0.07
11,NOTA,None of the Above,17981,50,18031,1.16
1,DR JAYANTA KUMAR ROY,Bharatiya Janata Party,763236,3332,766568,48.57
2,NIRMAL CHANDRA ROY,All India Trinamool Congress,677496,2379,679875,43.07
3,DEBRAJ BARMAN,Communist Party of India (Marxist),73629,463,74092,4.69
4,SHIPRA RAY HAKIM,Independent,9890,17,9907,0.63
5,BINOD MALLICK,Bahujan Samaj Party,8537,29,8566,0.54
6,HAREKRISHNA SARKAR,Independent,5837,11,5848,0.37
7,MAHESWAR BARMAN,Independent,4254,13,4267,0.27
8,RAM PRASAD MANDAL,Socialist Unity Centre Of India (COMMUNIST),3815,20,3835,0.24
9,MANABENDRA ROY,Kamatapur People’s Party (United),2899,51,2950,0.19
10,NIRODE CHANDRA ADHIKARY,Independent,2504,13,2517,0.16
11,ADHIR CHANDRA BARMAN,Independent,1911,16,1927,0.12
12,RANJIT BARMAN,Mulnibasi Party of India,1180,9,1189,0.08
13,NOTA,None of the Above,16807,41,16848,1.07
1,ABHIJIT GANGOPADHYAY,Bharatiya Janata Party,761183,4401,765584,48.54
2,DEBANGSHU BHATTACHARYA,All India Trinamool Congress,683955,3896,687851,43.61
3,SAYAN BANERJEE,Communist Party of India (Marxist),84774,615,85389,5.41
4,MOHIUDDIN AHMED MAHI,All India Secular Front,12303,36,12339,0.78
5,SURYANEEL DAS,Independent,6012,2,6014,0.38
6,NARAYAN CHANDRA NAYAK,Socialist Unity Centre Of India (COMMUNIST),5633,49,5682,0.36
7,SABITRI BISHAI,Bahujan Samaj Party,3724,30,3754,0.24
8,DEBAPRASAD JANA,Independent,1460,7,1467,0.09
9,KALIPADA DAS,Independent,947,27,974,0.06
10,NOTA,None of the Above,8223,42,8265,0.52
1,ADHIKARI SOUMENDU,Bharatiya Janata Party,757906,5289,763195,49.85
2,UTTAM BARIK SON OF LATE BIRENDRA BARIK,All India Trinamool Congress,709763,5668,715431,46.73
3,URBASI BANERJEE,Indian National Congress,30737,385,31122,2.03
4,BIDESH BASU MAITY,Independent,5633,21,5654,0.37
5,MANAS PRADHAN,Socialist Unity Centre Of India (COMMUNIST),2489,40,2529,0.17
6,UTTAM BARIK SON OF LATE NARAYAN BARIK,Independent,1963,35,1998,0.13
7,MAKHAN LAL MAHAPATRA,Bahujan Samaj Party,1792,12,1804,0.12
8,MD AHAMADULLAH KHAN,Independent,530,56,586,0.04
9,ARJUN KUMAR MAITY,Independent,504,40,544,0.04
10,NOTA,None of the Above,8075,59,8134,0.53
1,ADHIKARI DEEPAK (DEV),All India Trinamool Congress,834558,3432,837990,52.36
2,DR. HIRANMOY CHATTOPADHYAYA,Bharatiya Janata Party,652098,3024,655122,40.93
3,TAPAN GANGULI,Communist Party of India,74399,509,74908,4.68
4,SOUMEN MADRAJI,Bahujan Samaj Party,7916,25,7941,0.5
5,GOPAL MONDAL,Independent,4238,6,4244,0.27
6,DINESH MAIKAP,Socialist Unity Centre Of India (COMMUNIST),4124,24,4148,0.26
7,SAHEB CHOWDHURY,Independent,3228,9,3237,0.2
8,NOTA,None of the Above,12889,77,12966,0.81
1,KALIPADA SAREN (KHERWAL),All India Trinamool Congress,740132,3346,743478,49.87
2,DR. PRANAT TUDU,Bharatiya Janata Party,566553,2877,569430,38.2
3,SONAMANI TUDU,Communist Party of India (Marxist),76850,452,77302,5.19
4,SURYA SINGH BESRA,Jharkhand People's Party,19408,86,19494,1.31
5,BARUN MAHATO,Independent,12029,58,12087,0.81
6,ARUNKUMAR HANSDA,Bahujan Samaj Party,11949,40,11989,0.8
7,SURENDRANATH SING,Independent,10781,6,10787,0.72
8,RAMANATH ORANG,Independent,7178,10,7188,0.48
9,BIPLAB HEMBRAM,Independent,7156,14,7170,0.48
10,BAPI SOREN,All India Secular Front,5854,41,5895,0.4
11,BIRSABIR BASKEY,Ambedkarite Party of India,4344,18,4362,0.29
12,SUSHIL MANDI,Socialist Unity Centre Of India (COMMUNIST),2879,13,2892,0.19
13,GUNADHAR SING,Independent,2818,31,2849,0.19
14,NOTA,None of the Above,15871,49,15920,1.07
1,JUNE MALIAH,All India Trinamool Congress,699562,2630,702192,47.4
2,AGNIMITRA PAUL,Bharatiya Janata Party,671328,3673,675001,45.56
3,BIPLAB BHATTA,Communist Party of India,57345,440,57785,3.9
4,ANINDITA JANA,Socialist Unity Centre Of India (COMMUNIST),9744,47,9791,0.66
5,SANJIB DEY,Independent,8703,8,8711,0.59
6,ANJAN (BABALU) MANDAL,Bahujan Samaj Party,6483,20,6503,0.44
7,KAMALESH MAHATA,Independent,4229,21,4250,0.29
8,SUKESH CHANDRA PALMAL,Independent,2757,5,2762,0.19
9,BISWAJIT DAS,Independent,2141,3,2144,0.14
10,NOTA,None of the Above,12362,62,12424,0.84
1,JYOTIRMAY SINGH MAHATO,Bharatiya Janata Party,576246,2243,578489,40.34
2,SHANTIRAM MAHATO,All India Trinamool Congress,559325,2085,561410,39.15
3,NEPAL CHANDRA MAHATO,Indian National Congress,128565,592,129157,9.01
4,AJIT PRASAD MAHATA,Independent,98381,277,98658,6.88
5,DHIRENDRANATH MAHATO,All India Forward Bloc,14498,74,14572,1.02
6,SONTOSH RAJOWARD,Bahujan Samaj Party,7739,21,7760,0.54
7,SUSMITA MAHATO,Socialist Unity Centre Of India (COMMUNIST),6078,31,6109,0.43
8,GORISH ROY,Independent,4800,9,4809,0.34
9,BHAGWAT DASS SHASTRI,Independent,4508,4,4512,0.31
10,ASIT BARAN MAHATO,Party for Democratic Socialism,3868,9,3877,0.27
11,PIJUSH KANTI RAJAK,Independent,3408,10,3418,0.24
12,AJIT MAHATO,Independent,3309,9,3318,0.23
13,NOTA,None of the Above,17871,58,17929,1.25
1,ARUP CHAKRABORTY,All India Trinamool Congress,637465,4348,641813,44.33
2,DR. SUBHAS SARKAR,Bharatiya Janata Party,604836,4199,609035,42.07
3,NILANJAN DASGUPTA,Communist Party of India (Marxist),104534,825,105359,7.28
4,SURAJIT SINGH KURMALI,Independent,18507,62,18569,1.28
5,GOPAL MURMU,Ambedkarite Party of India,9047,54,9101,0.63
6,DIPA BOURI,Bahujan Samaj Party,8709,87,8796,0.61
7,MARSHAL TUDU,Independent,6682,35,6717,0.46
8,TARA SHANKAR GOPE,Socialist Unity Centre Of India (COMMUNIST),5490,39,5529,0.38
9,SANDIP KUMAR DEY,Independent,4610,12,4622,0.32
10,SAMAR KUMAR BISWAS,Kisan Mazdoor Sangharsh Party,3512,29,3541,0.24
11,JIBAN CHAKRABORTY,Independent,3483,23,3506,0.24
12,KARTIK CHANDRA BAURI,Independent,2741,55,2796,0.19
13,GOUR CHANDRA HEMBRAM,Independent,2064,17,2081,0.14
14,NOTA,None of the Above,26126,83,26209,1.81
1,KHAN SAUMITRA,Bharatiya Janata Party,677320,2810,680130,44.93
2,SUJATA MONDAL,All India Trinamool Congress,671148,3415,674563,44.56
3,SITAL CHANDRA KAIBARTYA,Communist Party of India (Marxist),104895,516,105411,6.96
4,SADANANDA MANDAL,Socialist Unity Centre Of India (COMMUNIST),16046,28,16074,1.06
5,JOYDEV DHANK,Bahujan Samaj Party,9027,52,9079,0.6
6,BASUDEB SIKARI,Independent,5093,13,5106,0.34
7,NARENDRANATH RAY,Independent,4360,17,4377,0.29
8,NOTA,None of the Above,19062,70,19132,1.26
1,DR. SHARMILA SARKAR,All India Trinamool Congress,717881,2421,720302,48.11
2,ASIM KUMAR SARKAR,Bharatiya Janata Party,557943,1787,559730,37.38
3,NIRAB KHAN,Communist Party of India (Marxist),176358,541,176899,11.81
4,NIRMAL MAJHI,Socialist Unity Centre Of India (COMMUNIST),10964,12,10976,0.73
5,MUKUL BISWAS,Bahujan Samaj Party,7610,21,7631,0.51
6,SHARMILA SARKAR,Independent,4875,18,4893,0.33
7,SAJAL KUMAR DE,Communist Party of India (Marxist-Leninist) (Liberation),4163,19,4182,0.28
8,NOTA,None of the Above,12654,43,12697,0.85
1,AZAD KIRTI JHA,All India Trinamool Congress,717069,3598,720667,47.99
2,DILIP GHOSH,Bharatiya Janata Party,579609,3077,582686,38.8
3,SUKRITI GHOSAL,Communist Party of India (Marxist),152851,978,153829,10.24
4,LUXMI NARAYAN KORA,Independent,7138,4,7142,0.48
5,PRABHU NATH SAH,Bahujan Samaj Party,6822,34,6856,0.46
6,TASBIRUL ISLAM,Socialist Unity Centre Of India (COMMUNIST),3450,19,3469,0.23
7,REENA LEONG,Independent,3100,11,3111,0.21
8,MIR SAKIMUDDIN,The National Road Map Party of India,2413,5,2418,0.16
9,NOTA,None of the Above,21532,63,21595,1.44
1,RAJU BISTA,Bharatiya Janata Party,675324,4007,679331,51.18
2,GOPAL LAMA,All India Trinamool Congress,498789,2017,500806,37.73
3,MUNISH TAMANG,Indian National Congress,82597,777,83374,6.28
4,BANDANA RAI,Independent,13155,519,13674,1.03
5,BISHNU PRASAD SHARMA,Independent,7431,16,7447,0.56
6,BHUPENDRA LEPCHA,Independent,6369,26,6395,0.48
7,ATASI BISWAS,Kisan Mazdoor Sangharsh Party,4586,55,4641,0.35
8,PRADHAN MARDI,Ambedkarite Party of India,2714,33,2747,0.21
9,KHUSHI RANJAN MANDAL,Independent,2313,24,2337,0.18
10,KALICHARAN BARMAN,Independent,2055,24,2079,0.16
11,QAMRUL HAQUE,North Bengal People’s Party,1829,24,1853,0.14
12,BUDHARU ROY,Kamatapur People’s Party (United),1734,28,1762,0.13
13,SHAHRIAR ALAM,Socialist Unity Centre Of India (COMMUNIST),1605,9,1614,0.12
14,SUBODH PAKHRIN,Gorkha Rashtriya Congress,1270,61,1331,0.1
15,NOTA,None of the Above,17960,61,18021,1.36
1,SHATRUGHAN PRASAD SINHA,All India Trinamool Congress,603105,2540,605645,46.53
2,SURENDRAJEET SINGH AHLUWALIA,Bharatiya Janata Party,544077,2004,546081,41.96
3,JAHANARA KHAN,Communist Party of India (Marxist),105454,510,105964,8.14
4,DIPIKA BAURI,Independent,10623,24,10647,0.82
5,SUNNY KUMAR SAH,Bahujan Samaj Party,8546,29,8575,0.66
6,SUJIT PAL,Independent,4749,11,4760,0.37
7,AMARNATH CHOWDHURY,Socialist Unity Centre Of India (COMMUNIST),4330,28,4358,0.33
8,NOTA,None of the Above,15448,62,15510,1.19
1,ASIT KUMAR MAL,All India Trinamool Congress,851209,4424,855633,55.98
2,PIYA SAHA,Bharatiya Janata Party,525463,2917,528380,34.57
3,SHYAMALI PRADHAN,Communist Party of India (Marxist),98819,564,99383,6.5
4,ATUL CHANDRA BAURI,Independent,7811,18,7829,0.51
5,DR MANIK CHANDRA PRODHAN,Bahujan Samaj Party,7011,28,7039,0.46
6,SHANTA DAS,Mulnibasi Party of India,3633,7,3640,0.24
7,BIJOY DOLUI,Socialist Unity Centre Of India (COMMUNIST),2774,18,2792,0.18
8,MANTU DHIBAR,Hindustan Shakti Sena,2048,4,2052,0.13
9,NOTA,None of the Above,21640,82,21722,1.42
1,SATABDI ROY,All India Trinamool Congress,714972,2989,717961,47.0
2,DEBTANU BHATTACHARYA,Bharatiya Janata Party,517761,2550,520311,34.06
3,MILTON RASHID,Indian National Congress,225572,688,226260,14.81
4,AMIY GHOSH,Independent,11950,8,11958,0.78
5,LAKSHMI HEMBROM,Ambedkarite Party of India,7677,10,7687,0.5
6,AYESHA KHATUN,Socialist Unity Centre Of India (COMMUNIST),6761,18,6779,0.44
7,RAJNATH SARKAR,Bahujan Samaj Party,5866,16,5882,0.39
8,SAURAV MUDI,Independent,4249,7,4256,0.28
9,ABDUL IMRAN,Independent,3823,9,3832,0.25
10,BISWAJIT MISHRA,All India Arya Mahasabha,3806,17,3823,0.25
11,MD. JAKIR HOSSAIN,Bharatiya National Janata Dal,2547,10,2557,0.17
12,DOLA SARKAR,Indian National Socialistic Action Forces,2027,6,2033,0.13
13,NOTA,None of the Above,14037,56,14093,0.92
1,KARTICK CHANDRA PAUL,Bharatiya Janata Party,558644,2253,560897,40.99
2,KALYANI KRISHNA,All India Trinamool Congress,491150,1550,492700,36.0
3,ALI IMRAN RAMZ,Indian National Congress,262694,579,263273,19.24
4,DWARIK NATH BARMAN,Independent,8258,6,8264,0.6
5,MD NAZIR AKHTAR,Independent,6004,1,6005,0.44
6,KALIDASH MURMU,Independent,5865,3,5868,0.43
7,SWAPAN KUMAR DAS,Bahujan Samaj Party,4106,11,4117,0.3
8,RUPAK ROY,Independent,3355,3,3358,0.25
9,FAKIRA MD,Independent,3353,2,3355,0.25
10,DURGA MURMU,Ambedkarite Party of India,3330,4,3334,0.24
11,PALASH CHANDRA MAHATO,Independent,3112,2,3114,0.23
12,ALI IMRAN,Independent,1939,7,1946,0.14
13,MD ABRAHIM HOQUE,Independent,1761,2,1763,0.13
14,SHAHIDUR RAHMAN,North Bengal People’s Party,1458,4,1462,0.11
15,SHARANYA DUTTA,Independent,1328,2,1330,0.1
16,SANATAN DUTTA,Socialist Unity Centre Of India (COMMUNIST),1256,15,1271,0.09
17,TAPAN BARMAN,Jai Prakash Janata Dal,1249,2,1251,0.09
18,ANWARUL HOQUE,Independent,1187,3,1190,0.09
19,RAMESH CHANDRA SINHA,Bhumiputra United Party,1046,5,1051,0.08
20,AL MONOWARA BEGAM,India Manus Party,977,5,982,0.07
21,NOTA,None of the Above,1924,16,1940,0.14
1,SUKANTA MAJUMDAR,Bharatiya Janata Party,572925,2071,574996,46.47
2,BIPLAB MITRA,All India Trinamool Congress,563252,1358,564610,45.63
3,JOYDEV KUMAR SIDDHANTA,Revolutionary Socialist Party,54081,136,54217,4.38
4,HAKIM MURMU,Independent,6820,2,6822,0.55
5,BAKHTIAR MUJAHIT SAHANI,Independent,6391,2,6393,0.52
6,RANENDRA NATH MALI,Independent,5590,3,5593,0.45
7,ANTA HANSDA,Bahujan Samaj Party,5130,15,5145,0.42
8,BISWANATH MURMU,Ambedkarite Party of India,3454,11,3465,0.28
9,MOZAMMEL HAQUE,All India Secular Front,2261,7,2268,0.18
10,NAROTTAM SAHA,Independent,2095,11,2106,0.17
11,MD. SARWARDI,Bhumiputra United Party,1957,10,1967,0.16
12,BIRENDRA NATH MAHANTA,Socialist Unity Centre Of India (COMMUNIST),1380,7,1387,0.11
13,RUBEL SARKAR,Kamatapur People’s Party (United),898,4,902,0.07
14,NOTA,None of the Above,7430,7,7437,0.6
1,KHAGEN MURMU,Bharatiya Janata Party,525109,1914,527023,37.18
2,PRASUN BANERJEE,All India Trinamool Congress,448234,1081,449315,31.7
3,ALAM MOSTAQUE,Indian National Congress,384063,701,384764,27.14
4,JATISH KISKU,Independent,8680,3,8683,0.61
5,MONATAN HEMBRAM,Independent,7927,6,7933,0.56
6,SWAPAN MAHATO,Independent,7235,2,7237,0.51
7,SANATAN RISHI,Bahujan Samaj Party,5624,8,5632,0.4
8,JOSEPH KISKU,Ambedkarite Party of India,4637,0,4637,0.33
9,MONJU HEMBROM,Independent,3535,3,3538,0.25
10,MD FARUQUE HOSSAIN,Independent,3374,1,3375,0.24
11,SOMNATH DAS,Bharatiya Nyay-Adhikar Raksha Party,3157,7,3164,0.22
12,SUBHASH BARMAN,Kamatapur People’s Party (United),2019,0,2019,0.14
13,KALICHARAN ROY,Socialist Unity Centre Of India (COMMUNIST),1286,7,1293,0.09
14,MD SOHEL,All India Secular Front,1090,2,1092,0.08
15,NARESH PAL,Jan Sangh Party,593,3,596,0.04
16,NOTA,None of the Above,7257,31,7288,0.51
1,ISHA KHAN CHOUDHURY,Indian National Congress,570966,1429,572395,41.79
2,SREERUPA MITRA CHAUDHURY (NIRBHAYA DIDI),Bharatiya Janata Party,441531,2496,444027,32.42
3,SHAHNAWAZ ALI RAIHAN,All India Trinamool Congress,299825,1201,301026,21.98
4,PURNOCHANDRA MANDAL,Independent,8381,2,8383,0.61
5,AHMED HEDATUL HASAN,Independent,5735,1,5736,0.42
6,MD. JAMAL SAIKH,Independent,5386,0,5386,0.39
7,BIKASH RABIDAS,Bahujan Samaj Party,5054,11,5065,0.37
8,BIJOY KUMAR SARKAR,Independent,4773,3,4776,0.35
9,SUSMITA DEY KARJEE,Bhartiya Lokmat Rashtrwadi Party,3521,14,3535,0.26
10,AMAL KUMAR RABIDAS,Independent,3263,8,3271,0.24
11,KAVIR MADAN DAS,Ambedkarite Party of India,3137,3,3140,0.23
12,ASIM MANDAL,Jan Sangh Party,2786,2,2788,0.2
13,MD SHAHNAWAJ RAHMATULLAH,Social Democratic Party Of India,2315,8,2323,0.17
14,JALALUDDIN SARKAR,Bharatiya Nyay-Adhikar Raksha Party,2075,0,2075,0.15
15,ANGSHUDHAR MANDAL,Socialist Unity Centre Of India (COMMUNIST),1178,11,1189,0.09
16,MD NUR ISLAM SEKH,Rashtriya Secular Majlis Party,1130,6,1136,0.08
17,MD MONIRUL HASAN,Jamat-E-Seratul Mustakim,737,4,741,0.05
18,NOTA,None of the Above,2759,38,2797,0.2
1,KHALILUR RAHAMAN,All India Trinamool Congress,543449,978,544427,39.75
2,MURTOJA HOSSAIN BOKUL,Indian National Congress,427105,685,427790,31.23
3,DHANANJAY GHOSH,Bharatiya Janata Party,339868,946,340814,24.88
4,REJAUL MONDAL,Independent,7500,0,7500,0.55
5,SAJAHAN BISWAS,All India Secular Front,6847,11,6858,0.5
6,MUKTIPADA KONAI,Independent,5670,1,5671,0.41
7,ASHISH BHUIMALI,Independent,3949,2,3951,0.29
8,MD SARWARUL ISLAM SARKAR,Bahujan Samaj Party,3511,4,3515,0.26
9,MD SAHABUDDIN,Social Democratic Party Of India,3489,7,3496,0.26
10,SAMIRUDDIN,Socialist Unity Centre Of India (COMMUNIST),1946,4,1950,0.14
11,PARIMAL GHOSH,Independent,1928,3,1931,0.14
12,SANUAR ALI,Bharatheeya Jawan Kisan Party,1698,2,1700,0.12
13,RAJIB CHATTERJEE,Bhartiya Lokmat Rashtrwadi Party,1527,5,1532,0.11
14,MD ASADUL BISWAS,Independent,1340,0,1340,0.1
15,NOTA,None of the Above,17135,23,17158,1.25
